Posted dt.,Doc dt.,Doc,Memo/Description,Location,Group Insight ID,Department,JNL,Debit,Credit,Balance
10PAVA - Cash : Pacific Aviation Health & Welfare (Balance forward As of 07/01/2023) ,,,,,,,,,,587703.97
7/3/2023,7/3/2023,793,Doc: 703 07/03/23 11555 Pacific Aviation : Evolution Benefits ; 06/26/23 - 07/02/23,PAV,0,,OBJ,,2292.84,585411.13
7/3/2023,7/3/2023,795,Doc: 00703 07/03/23 11555 (202306) Pacific Aviation Corporation : Medical,PAV,0,,OBJ,,793.86,584617.27
7/10/2023,7/10/2023,797,Doc: 00710 07/10/23 11555 Pacific Aviation : Evolution Benefits ; 07/03/23 - 07/09/23,PAV,0,,OBJ,,366.19,584251.08
7/12/2023,7/12/2023,809,Doc: 00712 07/12/23 11555 (202307) Pacific Aviation Corporation : Medical,PAV,0,,OBJ,,912.94,583338.14
7/12/2023,7/12/2023,811,Doc: 00712 07/12/23 11555 (202306) Pacific Aviation Corporation : Medical/Basic Life and AD&D,PAV,0,,OBJ,,204615.69,378722.45
7/14/2023,7/14/2023,817,Doc: 0714MTA 07/14/23 11555 Pacific Aviation Corp; WIRE: 07.13.2023 INCOMING WIRE,PAV,0,,OBJ,310601.03,,689323.48
7/20/2023,7/20/2023,821,Doc: 00720 07/20/23 11555 Pacific Aviation : Evolution Benefits ; 07/10/23 - 07/16/23,PAV,0,,OBJ,,1938.14,687385.34
7/24/2023,7/24/2023,825,Doc: 724 07/24/23 11555 Pacific Aviation : Evolution Benefits ; 07/17/23 - 07/23/23,PAV,0,,OBJ,,990.18,686395.16
7/31/2023,7/31/2023,833,Doc: 00731 07/31/23 11555 Pacific Aviation : Evolution Benefits ; 07/24/23 - 07/30/23,PAV,0,,OBJ,,1011.97,685383.19
7/31/2023,7/31/2023,856,11555 (202307) Pacific Aviation : Cash Mgmt Sweep Fee,PAV,0,,OBJ,,285.42,685097.77
7/31/2023,7/31/2023,858,11555 (202307) Pacific Aviation : Bank Fee,PAV,0,,OBJ,,250,684847.77
7/31/2023,7/31/2023,860,11555 (202307) Pacific Aviation : Interest Revenue,PAV,0,,OBJ,2439.45,,687287.22
8/2/2023,8/2/2023,837,"Doc: 00802 08/02/23 11555 (202306) Pacific Aviation : Dental, Vision, Ancillary",PAV,0,,OBJ,,10171.33,677115.89
8/2/2023,8/2/2023,839,Doc: 00802 08/02/23 11555 (202306) Pacific Aviation : Anthem HAS,PAV,0,,OBJ,,120,676995.89
8/7/2023,8/7/2023,847,Doc: 00807 08/07/23 11555 Pacific Aviation : Evolution Benefits ; 07/31/23 - 08/06/23,PAV,0,,OBJ,,1388.26,675607.63
8/8/2023,8/8/2023,851,Doc: 0808MTA 08/08/23 11555 Pacific Aviation Corp : HRA 080123 ; Check Register 080123,PAV,0,,OBJ,,200,675407.63
8/14/2023,8/14/2023,861,Doc: 00814 08/14/23 11555 Pacific Aviation : Evolution Benefits ; 08/07/23 - 08/13/23,PAV,0,,OBJ,,1281.15,674126.48
8/18/2023,8/18/2023,938,Doc: 0818 08/18/23 11555 (202306) Pacific Aviation : Boon Trust Fees,PAV,0,,OBJ,,13322,660804.48
8/21/2023,8/21/2023,940,Doc: 00821 08/21/23 11555 Pacific Aviation : Evolution Benefits ; 08/14/23 - 08/20/23,PAV,0,,OBJ,,1308.16,659496.32
8/28/2023,8/28/2023,952,Doc: 00829 08/28/23 11555 Pacific Aviation : Evolution Benefits ; MM/DD/YY - MM/DD/YY,PAV,0,,OBJ,,319.97,659176.35
8/30/2023,8/30/2023,964,Doc: 0830MPA 08/30/23 11555 Pacific Aviation Corp; WIRE: 08.29.2023 INCOMING WIRE,PAV,0,,OBJ,234975.47,,894151.82
8/30/2023,8/30/2023,966,Doc: 00830 08/30/23 11555 (202307) Pacific Aviation Corporation : Anthem HSA Contributions,PAV,0,,OBJ,,265.38,893886.44
8/30/2023,8/30/2023,968,"Doc: 00830 08/30/23 11555 (202307) Pacific Aviation Corporation : Dental, Vision, and Ancillary Benefits",PAV,0,,OBJ,,13550.43,880336.01
8/30/2023,8/30/2023,970,Doc: 00830 08/30/23 11555 (202308) Pacific Aviation Corporation : Medical / Basic Life and AD&D,PAV,0,,OBJ,,235992.47,644343.54
8/31/2023,8/31/2023,978,Doc: 0831 08/31/23 11555 (202307) Pacific Aviation : Boon Trust Fees,PAV,0,,OBJ,,15381,628962.54
8/31/2023,8/31/2023,987,11555 (202308) Pacific Aviation : Bank Fee,PAV,0,,OBJ,,250,628712.54
8/31/2023,8/31/2023,989,11555 (202308) Pacific Aviation : Cash Mgmt Sweep Fee,PAV,0,,OBJ,,230.01,628482.53
8/31/2023,8/31/2023,991,11555 (202308) Pacific Aviation : Interest Revenue,PAV,0,,OBJ,3397.32,,631879.85
9/5/2023,9/5/2023,980,Doc: 00905 09/05/23 11555 Pacific Aviation : Evolution Benefits ; 08/28/23 - 09/03/23,PAV,0,,OBJ,,2199.06,629680.79
9/11/2023,9/11/2023,992,Doc: 00911 09/11/23 11555 Pacific Aviation : Evolution Benefits ; 09/04/23 - 09/10/23,PAV,0,,OBJ,,1761.79,627919
9/12/2023,9/12/2023,996,Doc: 0912MPA 09/12/23 11555 Pacific Aviation Corp; WIRE: 09.11.2023 INCOMING WIRE,PAV,0,,OBJ,265262.05,,893181.05
9/15/2023,9/15/2023,998,Doc: 0915 09/15/23 11555 (202304) Pacific Aviation : HRA Debit Card Fee,PAV,0,,OBJ,,20,893161.05
9/15/2023,9/15/2023,1000,Doc: 0915 09/15/23 11555 (202305) Pacific Aviation : HRA Debit Card Fee,PAV,0,,OBJ,,40,893121.05
9/15/2023,9/15/2023,1002,Doc: 0915 09/15/23 11555 (202306) Pacific Aviation : HRA Debit Card Fee,PAV,0,,OBJ,,30,893091.05
9/15/2023,9/15/2023,1086,Doc: 0915 09/15/23 11555 (202304) Pacific Aviation : HRA Debit Card Fee,PAV,0,,OBJ,20,,893111.05
9/15/2023,9/15/2023,1088,Doc: 0915 09/15/23 11555 (202305) Pacific Aviation : HRA Debit Card Fee,PAV,0,,OBJ,40,,893151.05
9/15/2023,9/15/2023,1090,Doc: 0915 09/15/23 11555 (202306) Pacific Aviation : HRA Debit Card Fee,PAV,0,,OBJ,30,,893181.05
9/15/2023,9/15/2023,1092,Doc: 0915 09/15/23 11555 (202304) Pacific Aviation : HRA Debit Card Fee,PAV,0,,OBJ,,20,893161.05
9/15/2023,9/15/2023,1094,Doc: 0915 09/15/23 11555 (202305) Pacific Aviation : HRA Debit Card Fee,PAV,0,,OBJ,,40,893121.05
9/15/2023,9/15/2023,1096,Doc: 0915 09/15/23 11555 (202306) Pacific Aviation : HRA Debit Card Fee,PAV,0,,OBJ,,30,893091.05
9/18/2023,9/18/2023,1014,Doc: 00918 09/18/23 11555 Pacific Aviation : Evolution Benefits ; 09/11/23 - 09/17/23,PAV,0,,OBJ,,1476.19,891614.86
9/20/2023,9/20/2023,1016,Doc: 00920 09/20/23 11555 (202308) Pacific Aviation Corporation : Anthem HSA Contributions,PAV,0,,OBJ,,235.38,891379.48
9/20/2023,9/20/2023,1018,Doc: 00920 09/20/23 11555 (202308) Pacific Aviation Corporation : Medical,PAV,0,,OBJ,,912.94,890466.54
9/20/2023,9/20/2023,1020,Doc: 00920 09/20/23 11555 (202308) Pacific Aviation Corporation : Dental Vision and Ancilliary Benefits,PAV,0,,OBJ,,13156.26,877310.28
9/20/2023,9/20/2023,1022,Doc: 00920 09/20/23 11555 (202309) Pacific Aviation Corporation : Medical / Basic Life and AD&D,PAV,0,,OBJ,,336928.46,540381.82
9/20/2023,9/20/2023,1024,Doc: 00920 09/20/23 11555 (202309) Pacific Aviation Corporation : Medical,PAV,0,,OBJ,,912.94,539468.88
9/25/2023,9/25/2023,1044,Doc: 0925MPA 09/25/23 11555 Pacific Aviation Corp; ACH: 09.22.2023 INCOMING ACH,PAV,0,,OBJ,91793.11,,631261.99
9/25/2023,9/25/2023,1046,Doc: 925 09/25/23 11555 Pacific Aviation : Evolution Benefits ; 09/18/23 - 09/24/23,PAV,0,,OBJ,,4497.61,626764.38
9/28/2023,9/28/2023,1050,Doc: 00928 09/28/23 11555 (202310) Pacific Aviation Corporation : Medical,PAV,0,,OBJ,,1369.41,625394.97
9/29/2023,9/29/2023,1054,Doc: 0929USA 09/29/23 11555 (202306) Pacific Aviation : Bank Fee,PAV,0,,OBJ,250,,625644.97
9/29/2023,9/29/2023,1056,Doc: 929 09/29/23 11555 (202308) Pacific Aviation : Boon Trust Fees,PAV,0,,OBJ,,14685,610959.97
9/30/2023,9/30/2023,1079,11555 (202309) Pacific Aviation : Cash Mgmt Sweep Fee,PAV,0,,OBJ,,309.38,610650.59
9/30/2023,9/30/2023,1081,11555 (202309) Pacific Aviation : Bank Fee,PAV,0,,OBJ,,250,610400.59
9/30/2023,9/30/2023,1083,11555 (202309) Pacific Aviation : Interest Revenue,PAV,0,,OBJ,3025.57,,613426.16
10/2/2023,10/2/2023,1156,Doc: 1002 10/02/23 11555 Pacific Aviation : Evolution Benefits ; 09/25/23 - 10/01/23,PAV,0,,OBJ,,1981.8,611444.36
10/4/2023,10/4/2023,1072,Doc: 1003MPA 10/04/23 11555 Pacific Aviation : HRA 100223 ; Check Register 100223,PAV,0,,OBJ,400,,611844.36
10/6/2023,10/6/2023,1074,Doc: 1006MPA 10/06/23 11555 Pacific Aviation Corp; ACH: 10.05.2023 INCOMING ACH,PAV,0,,OBJ,66139.66,,677984.02
10/10/2023,10/10/2023,1098,Doc: 01010 10/10/23 11555 (202310) Pacific Aviation Corporation : Medical,PAV,0,,OBJ,,456.47,677527.55
10/10/2023,10/10/2023,1104,Doc: 1010MPA 10/10/23 11555 Pacific Aviation Corp; WIRE: 10.09.2023 INCOMING WIRE,PAV,0,,OBJ,368401.55,,1045929.1
10/10/2023,10/10/2023,1106,Doc: 01010 10/10/23 11555 Pacific Aviation : Evolution Benefits ; 10/02/23 - 10/08/23,PAV,0,,OBJ,,1171.6,1044757.5
10/10/2023,10/10/2023,1108,Doc: 1010MPA 10/10/23 11555 Pacific Aviation : HRA 100223 ; Check Register 100223,PAV,0,,OBJ,,600,1044157.5
10/16/2023,10/16/2023,1120,Doc: 01016 10/16/23 11555 Pacific Aviation : Evolution Benefits ; 10/09/23 - 10/15/23,PAV,0,,OBJ,,969.76,1043187.74
10/17/2023,10/17/2023,1124,Doc: 1017MPA 10/17/23 11555 Pacific Aviation : HRA 101123 ; Check Register 101123,PAV,0,,OBJ,,228.78,1042958.96
10/17/2023,10/17/2023,1130,Doc: 01017 10/17/23 11555 (202303) Pacific Aviation Corporation : Medical/ Basic Life and AD&D,PAV,0,,OBJ,,1491.79,1041467.17
10/17/2023,10/17/2023,1132,Doc: 01017 10/17/23 11555 (202310) Pacific Aviation Corporation : Medical/ Basic Life and AD&D,PAV,0,,OBJ,,246286.86,795180.31
10/20/2023,10/20/2023,1136,Doc: 1020MTA 10/20/23 11555 Pacific Aviation Corp; ACH: 10.19.2023 INCOMING ACH,PAV,0,,OBJ,278899.53,,1074079.84
10/24/2023,10/24/2023,1138,Doc: 01024 10/24/23 11555 (202311) Pacific Aviation Corporation : Medical,PAV,0,,OBJ,,1369.41,1072710.43
10/24/2023,10/24/2023,1140,Doc: 01024 10/24/23 11555 Pacific Aviation : Evolution Benefits ; 10/16/23 - 10/22/23,PAV,0,,OBJ,,2391.34,1070319.09
10/25/2023,10/25/2023,1148,Doc: 1025MPA 10/25/23 11555 Pacific Aviation : HRA 101823 ; Check Register 101823,PAV,0,,OBJ,,246.36,1070072.73
10/30/2023,10/30/2023,1150,Doc: 01030 10/30/23 11555 Pacific Aviation : Evolution Benefits ; 10/23/23 - 10/29/23,PAV,0,,OBJ,,1108.29,1068964.44
10/31/2023,10/31/2023,1154,Doc: 1031MPA 10/31/23 11555 Pacific Aviation : HRA 102523 ; Check Register 102523,PAV,0,,OBJ,,762.22,1068202.22
10/31/2023,10/31/2023,1160,Doc: 01031 10/31/23 11555 (202310) Pacific Aviation Corporation : Anthem HSA Contributions,PAV,0,,OBJ,,470.76,1067731.46
10/31/2023,10/31/2023,1187,11555 (202310) Pacific Aviation : Cash Mgmt Sweep Fee,PAV,0,,OBJ,,284.55,1067446.91
10/31/2023,10/31/2023,1189,11555 (202310) Pacific Aviation : Bank Fee,PAV,0,,OBJ,,250,1067196.91
10/31/2023,10/31/2023,1191,11555 (202310) Pacific Aviation : Interest Revenue,PAV,0,,OBJ,4189.48,,1071386.39
11/1/2023,11/1/2023,1168,Doc: 1101GNA 11/01/23 11555 Pacific Aviation Corp; ACH: 10.31.2023 INCOMING ACH,PAV,0,,OBJ,33764.02,,1105150.41
11/6/2023,11/6/2023,1170,Doc: 01106 11/06/23 11555 Pacific Aviation : Evolution Benefits ; 10/30/23 - 11/05/23,PAV,0,,OBJ,,3344.12,1101806.29
11/7/2023,11/7/2023,1176,"Doc: 01107 11/07/23 11555 (202309) Pacific Aviation : Dental, Vision and Acilliary Benefits",PAV,0,,OBJ,,13243.79,1088562.5
11/8/2023,11/8/2023,1182,"Doc: 01108 11/08/23 11555 (202310) Pacific Aviation : Dental, Vision and Ancilliary Benefits",PAV,0,,OBJ,,14137.42,1074425.08
11/13/2023,11/13/2023,1194,Doc: 1113 11/13/23 11555 Pacific Aviation : Evolution Benefits ; 11/06/23 - 11/12/23,PAV,0,,OBJ,,3256.47,1071168.61
11/14/2023,11/14/2023,1196,Doc: 01114 11/14/23 11555 (202311) Pacific Aviation Corporation : Medical / Basic Life and AD&D,PAV,0,,OBJ,,358688.63,712479.98
11/15/2023,11/15/2023,1202,Doc: 1115 11/15/23 11555 (202309) Pacific Aviation : Boon Trust Fees,PAV,0,,OBJ,,16831,695648.98
11/16/2023,11/16/2023,1206,Doc: 1116MPA 11/16/23 11555 Pacific Aviation Corp; ACH: 11.15.2023 INCOMING ACH,PAV,0,,OBJ,391395.83,,1087044.81
11/20/2023,11/20/2023,1214,Doc: 01120 11/20/23 11555 Pacific Aviation : Evolution Benefits ; 11/13/23 - 11/19/23,PAV,0,,OBJ,,4124.49,1082920.32
11/21/2023,11/21/2023,1218,"Doc: 01121 11/21/23 11555 (202311) Pacific Aviation : Dental, Vision, and Ancilliary Benefits",PAV,0,,OBJ,,14137.42,1068782.9
11/27/2023,11/27/2023,1228,Doc: 01127 11/27/23 11555 Pacific Aviation : Evolution Benefits ; 11/20/23 - 11/26/23,PAV,0,,OBJ,,4985.92,1063796.98
11/29/2023,11/29/2023,1236,Doc: 1129MTA 11/29/23 11189 (202310) CoreCivic : 10.25.23 HRA manual check paid from PAV,PAV,0,,OBJ,246.36,,1064043.34
11/29/2023,11/29/2023,1238,Doc: 1129MTA 11/29/23 11189 (202310) CoreCivic : 10.31.23 HRA manual check paid from PAV,PAV,0,,OBJ,762.22,,1064805.56
11/30/2023,11/30/2023,1255,11555 (202311) Pacific Aviation : Cash Mgmt Sweep Fee,PAV,0,,OBJ,,380.43,1064425.13
11/30/2023,11/30/2023,1257,11555 (202311) Pacific Aviation : Bank Fee,PAV,0,,OBJ,,250,1064175.13
11/30/2023,11/30/2023,1259,11555 (202311) Pacific Aviation : Interest,PAV,0,,OBJ,4711.61,,1068886.74
12/4/2023,12/4/2023,,11555 Pacific Aviation : Evolution Benefits ; 11/27/23 - 12/03/23,PAV,11555,,GJ,,1961.05,1066925.69
12/5/2023,12/5/2023,,11555 Pacific Aviation Corp : HRA 120123 ; Check Register 120123,PAV,11555,,GJ,,30,1066895.69
12/11/2023,12/11/2023,,11555 Pacific Aviation : Evolution Benefits ; 12/04/23 - 12/10/23,PAV,11555,,GJ,,2474.91,1064420.78
12/15/2023,12/15/2023,,11555 Pacific Aviation Corp; ACH: 12.13.2023 INCOMING ACH,PAV,11555,,GJ,301374.18,,1365794.96
12/18/2023,12/18/2023,,11555 Pacific Aviation : Evolution Benefits ; 12/11/23 - 12/17/23,PAV,11555,,GJ,,3285.65,1362509.31
12/18/2023,12/18/2023,,11555 (202312) Pacific Aviation Corporation : Anthem HSA Contributions,PAV,11555,,GJ,,470.76,1362038.55
12/18/2023,12/18/2023,,"11555 (202312) Pacific Aviation Corporation : Dental, Vision and Ancillary Benefits",PAV,11555,,GJ,,11409.53,1350629.02
12/18/2023,12/18/2023,,11555 (202312) Pacific Aviation Corporation : Medical / Basic Life and AD&D,PAV,11555,,GJ,,271500.98,1079128.04
12/26/2023,12/26/2023,,11555 Pacific Aviation : Evolution Benefits ; 12/18/23 - 12/24/23,PAV,11555,,GJ,,1814.91,1077313.13
12/26/2023,12/26/2023,,11555 Pacific Aviation Corp : HRA 121923 ; Check Register 121923,PAV,11555,,GJ,,30.41,1077282.72
12/28/2023,12/28/2023,,11555 (202310-202312) Pacific Aviation : Boon Trust Fees,PAV,11555,,GJ,,47738,1029544.72
12/28/2023,12/28/2023,,11555 (202312) Pacific Aviation : Boon Trust Fees,PAV,11555,,GJ,,47738,981806.72
12/28/2023,12/28/2023,Reversed -,Reversed -- 11555 (202312) Pacific Aviation : Boon Trust Fees,PAV,11555,,GJ,47738,,1029544.72
12/31/2023,12/31/2023,,Bank Service Charge: 11555 (202312) Pacific Aviation : Cash Mgmt Sweep Fee,PAV,11555,,CDJ,,439.71,1029105.01
12/31/2023,12/31/2023,,Bank Interest Earned: 11555 (202312) Pacific Aviation : Interest,PAV,11555,,CDJ,5053.02,,1034158.03
12/31/2023,12/31/2023,,Bank Service Charge: 11555 (202312) Pacific Aviation : Bank Fee,PAV,11555,,CDJ,,250,1033908.03
1/2/2024,1/2/2024,,11555 Pacific Aviation : Evolution Benefits ; 12/25/23 - 01/01/24,PAV,11555,,GJ,,2053.37,1031854.66
1/8/2024,1/8/2024,,11555 Pacific Aviation : Evolution Benefits ; 01/01/24 - 01/07/24,PAV,11555,,GJ,,2568.97,1029285.69
1/16/2024,1/16/2024,,11555 Pacific Aviation Corp; ACH: 01.12.2024 INCOMING ACH,PAV,11555,,GJ,75917.1,,1105202.79
1/16/2024,1/16/2024,,11555 Pacific Aviation : Evolution Benefits ; 01/08/24 - 01/14/24,PAV,11555,,GJ,,2247.93,1102954.86
1/22/2024,1/22/2024,,11555 Pacific Aviation : Evolution Benefits ; 01/15/23 - 01/21/23,PAV,11555,,GJ,,2648.22,1100306.64
1/26/2024,1/26/2024,,11555 Pacific Aviation Corp; ACH: 01.25.2024 INCOMING ACH,PAV,11555,,GJ,33970.17,,1134276.81
1/26/2024,1/26/2024,,"11555 (202401) Pacific Aviation Corporation : Dental, Vision, Ancilliary Benefits",PAV,11555,,GJ,,12207.26,1122069.55
1/26/2024,1/26/2024,,11555 (202401) Pacific Aviation Corporation : Medical / Basic Life and AD&D,PAV,11555,,GJ,,226078.75,895990.8
1/29/2024,1/29/2024,,11555 Pacific Aviation : Evolution Benefits ; 01/22/24 - 01/28/24,PAV,11555,,GJ,,2981.13,893009.67
1/31/2024,1/31/2024,,11555 Pacific Aviation Corp; ACH: 01.30.2024 INCOMING ACH,PAV,11555,,GJ,255102.39,,1148112.06
1/31/2024,1/31/2024,,11555 (202401) Pacific Aviation : Anthem Life,PAV,11555,,GJ,,3244.5,1144867.56
1/31/2024,1/31/2024,,Bank Interest Earned,PAV,0,,CDJ,4763.02,,1149630.58
1/31/2024,1/31/2024,,Bank Service Charge,PAV,0,,CDJ,,455.88,1149174.7
1/31/2024,1/31/2024,,Bank Interest Earned,PAV,0,,CDJ,0,,1149174.7
1/31/2024,1/31/2024,,Bank Service Charge,PAV,0,,CDJ,,250,1148924.7
2/5/2024,2/5/2024,,11555 Pacific Aviation : Evolution Benefits ; 01/29/24 - 02/04/24,PAV,11555,,GJ,,4990.84,1143933.86
2/6/2024,2/6/2024,,11555 (202401) Pacific Aviation Corporation : Medical / Basic Life and AD&D,PAV,11555,,GJ,,277621.4,866312.46
2/9/2024,2/9/2024,,Bank Interest Earned,PAV,0,,CDJ,4763.02,,871075.48
2/9/2024,2/9/2024,,Bank Interest Earned: Incorrect Date Used,PAV,0,,CDJ,,4763.02,866312.46
2/9/2024,2/9/2024,,Bank Service Charge,PAV,0,,CDJ,,250,866062.46
2/9/2024,2/9/2024,,Bank Service Charge: Incorrect Date Used,PAV,0,,CDJ,250,,866312.46
2/12/2024,2/12/2024,,11555 Pacific Aviation : Evolution Benefits ; 02/05/24 - 02/11/24,PAV,11555,,GJ,,3265.04,863047.42
2/14/2024,2/14/2024,,11555 Pacific Aviation Corp; ACH: 02.13.2024 INCOMING ACH,PAV,11555,,GJ,305400.91,,1168448.33
2/14/2024,2/14/2024,,11555 Pacific Aviation Corp; CHECK: 6625,PAV,11555,,GJ,3382.36,,1171830.69
2/14/2024,2/14/2024,,11555 (202303) Pacific Aviation : Medical / Basic Life and AD&D,PAV,11555,,GJ,,260923.41,910907.28
2/14/2024,2/14/2024,,11555 (202312) Pacific Aviation : Anthem Life / Compassi,PAV,11555,,GJ,,2003.8,908903.48
2/14/2024,2/14/2024,,"11555 (202402 Pacific Aviation : Dental, Vision and Ancillary Benefits",PAV,11555,,GJ,,12673.05,896230.43
2/14/2024,2/14/2024,,11555 (202402) Pacific Aviation : Anthem HSA Contributions,PAV,11555,,GJ,,470.76,895759.67
2/16/2024,2/16/2024,,11555 (202402) Pacific Aviation : Boon Trust Fees,PAV,11555,,GJ,,31284,864475.67
2/20/2024,2/20/2024,,11555 Pacific Aviation : Evolution Benefits ; 02/12/24 - 02/18/24,PAV,11555,,GJ,,4857.24,859618.43
2/21/2024,2/21/2024,,11555 Pacific Aviation Corp : HRA 021224 ; Check Register 021224,PAV,11555,,GJ,,8.62,859609.81
2/26/2024,2/26/2024,,11555 Pacific Aviation : Evolution Benefits ; 02/19/24 - 02/25/24,PAV,11555,,GJ,,3233.65,856376.16
2/27/2024,2/27/2024,,"11555 (202402) Pacific Aviation : Dental, Vision, and Ancillary Benefits",PAV,11555,,GJ,,74.66,856301.5
2/28/2024,2/28/2024,,11555 Pacific Aviation Corp; ACH: 02.27.2024 INCOMING ACH,PAV,11555,,GJ,32528.83,,888830.33
2/29/2024,2/29/2024,,Bank Interest Earned: 11555 Pacific Aviation Corp : Interest Revenue,PAV,,,CDJ,3924.37,,892754.7
2/29/2024,2/29/2024,,Bank Service Charge: 11555 Pacific Aviation Corp : Bank Fees,PAV,,,CDJ,,681.11,892073.59
3/4/2024,3/4/2024,,11555 Pacific Aviation : Evolution Benefits ; 02/26/24- 03/03/24,PAV,11555,,GJ,,1387.18,890686.41
3/4/2024,3/4/2024,,11555 Pacific Aviation Corp; ACH: 03.01.2024 INCOMING ACH,PAV,11555,,GJ,94.42,,890780.83
3/11/2024,3/11/2024,,11555 Pacific Aviation : Evolution Benefits ; 03/04/24 - 03/10/24,PAV,11555,,GJ,,3645.2,887135.63
3/13/2024,3/13/2024,,11555 Pacific Aviation Corp; ACH: 03.12.2024 INCOMING ACH,PAV,11555,,GJ,288194.93,,1175330.56
3/18/2024,3/18/2024,,11555 Pacific Aviation : Evolution Benefits ; 03/11/24 - 03/17/24,PAV,11555,,GJ,,4119.25,1171211.31
3/18/2024,3/18/2024,,"11555 (202402) Pacific Aviation : Dental, Vision and Ancillary Benefits",PAV,11555,,GJ,,12047.35,1159163.96
3/18/2024,3/18/2024,,11555 (202403) Pacific Aviation : Anthem HAS Contributions,PAV,11555,,GJ,,235.38,1158928.58
3/18/2024,3/18/2024,,11555 (202404) Pacific Aviation : Medical / Basic Life and AD&D,PAV,11555,,GJ,,289443.11,869485.47
3/21/2024,3/21/2024,,11555 Pacific Aviation Corp; ACH: 03.20.2024 INCOMING ACH,PAV,11555,,GJ,82376.74,,951862.21
3/25/2024,3/25/2024,,11555 (202403) Pacific Aviation : Boon Trust Fees,PAV,11555,,GJ,,14917,936945.21
3/25/2024,3/25/2024,,11555 Pacific Aviation : Evolution Benefits ; 03/18/24 - 03/24/24,PAV,11555,,GJ,,3101.64,933843.57
3/27/2024,3/27/2024,,11555 Pacific Aviation Corp; ACH: 03.26.2024 INCOMING ACH,PAV,11555,,GJ,32348.32,,966191.89
3/31/2024,3/31/2024,,Bank Interest Earned: 11555 (202403) Pacific Aviation Corp : Interest Revenue,PAV,,,CDJ,4368.29,,970560.18
3/31/2024,3/31/2024,,Bank Service Charge: 11555 (202403) Pacific Aviation Corp : Bank Fees,PAV,,,CDJ,,631.39,969928.79
4/1/2024,4/1/2024,,11555 Pacific Aviation : Evolution Benefits ; 03/25/24 - 03/31/24,PAV,11555,,GJ,,1341.39,968587.4
4/8/2024,4/8/2024,,11555 Pacific Aviation : Evolution Benefits ; 04/01/24 - 04/07/24,PAV,11555,,GJ,,3835.62,964751.78
4/9/2024,4/9/2024,,11555 Pacific Aviation Corp : HRA 040224 ; Check Register 040224,PAV,11555,,GJ,,22.2,964729.58
4/15/2024,4/15/2024,,11555 Pacific Aviation : Evolution Benefits ; 04/08/24 - 04/14/24,PAV,11555,,GJ,,4325.37,960404.21
4/19/2024,4/19/2024,,11555 Pacific Aviation Corp; ACH: 04.18.2024 INCOMING ACH,PAV,11555,,GJ,325667.72,,1286071.93
4/19/2024,4/19/2024,,11555 (202404) Pacific Aviation Corporation : Anthem HSA Contributions,PAV,11555,,GJ,,235.38,1285836.55
4/19/2024,4/19/2024,,11555 (202404) Pacific Aviation Corporation : Anthem Life/Compassi,PAV,11555,,GJ,,1746.18,1284090.37
4/19/2024,4/19/2024,,"11555 (202404) Pacific Aviation Corporation : Dental, Vision, and Ancillary Benefits",PAV,11555,,GJ,,12447.53,1271642.84
4/22/2024,4/22/2024,,11555 Pacific Aviation : Evolution Benefits ; 04/15/24 - 04/21/24,PAV,11555,,GJ,,2694.73,1268948.11
4/25/2024,4/25/2024,,11555 (202404) Pacific Aviation : Boon Trust Fees,PAV,11555,,GJ,,17759,1251189.11
4/29/2024,4/29/2024,,11555 Pacific Aviation : Evolution Benefits ; 04/22/24/ - 04/28/24,PAV,11555,,GJ,,3488.27,1247700.84
4/30/2024,4/30/2024,,11555 Pacific Aviation Corp; ACH: 04.29.2024 INCOMING ACH,PAV,11555,,GJ,29987.83,,1277688.67
4/30/2024,4/30/2024,,Bank Interest Earned: 11555 (202404) Pacific Aviation Corp : Interest Revenue,PAV,,,CDJ,4778.03,,1282466.7
4/30/2024,4/30/2024,,Bank Service Charge: 11555 (202404) Pacific Aviation Corp : Cash Management Sweep Fee,PAV,11555,,CDJ,,398.67,1282068.03
5/6/2024,5/6/2024,,11555 Pacific Aviation : Evolution Benefits ; 04/29/24 - 05/05/24,PAV,11555,,GJ,,2860.26,1279207.77
5/8/2024,5/8/2024,,11555 Pacific Aviation Corp; CHECK: 269,PAV,11555,,GJ,8.18,,1279215.95
5/13/2024,5/13/2024,,11555 Pacific Aviation : Evolution Benefits ; 05/06/24 - 05/12/24,PAV,11555,,GJ,,1008.61,1278207.34
5/20/2024,5/20/2024,,11555 Pacific Aviation : Evolution Benefits ; 05/13/24 - 05/19/24,PAV,11555,,GJ,,3946.7,1274260.64
5/21/2024,5/21/2024,,11555 Pacific Aviation Corp : HRA 051624 ; Check Register 051624,PAV,11555,,GJ,,25.42,1274235.22
5/22/2024,5/22/2024,,11555 Pacific Aviation Corp; ACH: 05.21.2024 INCOMING ACH,PAV,11555,,GJ,291310.64,,1565545.86
5/23/2024,5/23/2024,,11555 (202405) Pacific Aviation : Anthem Life/Compassi,PAV,11555,,GJ,,1798.68,1563747.18
5/23/2024,5/23/2024,,"11555 (202405) Pacific Aviation : Dental, Vision, and Ancillary Benefits",PAV,11555,,GJ,,11836.62,1551910.56
5/23/2024,5/23/2024,,11555 (202405) Pacific Aviation Corporation : Anthem HSA Contributions,PAV,11555,,GJ,,235.38,1551675.18
5/23/2024,5/23/2024,,11555 (202405) Pacific Aviation Corporation : Medical/ Basic Life and AD&D,PAV,11555,,GJ,,260938.96,1290736.22
5/28/2024,5/28/2024,,11555 Pacific Aviation : Evolution Benefits ; 05/20/24 - 05/27/24,PAV,11555,,GJ,,3823.08,1286913.14
5/28/2024,5/28/2024,,11555 (202405) Pacific Aviation : Boon Trust Fees,PAV,11555,,GJ,,16251,1270662.14
5/31/2024,5/31/2024,,Bank Interest Earned: 11555 (202405) Pacific Aviation Corp : Interest Revenue,PAV,,,CDJ,5858.59,,1276520.73
5/31/2024,5/31/2024,,Bank Service Charge: 11555 (202405) Pacific Aviation Corp : Bank Fees,PAV,,,CDJ,,500,1276020.73
5/31/2024,5/31/2024,,Bank Service Charge: 11555 (202405) Pacific Aviation Corp : Cash Management Sweep Fee,PAV,11555,,CDJ,,451.6,1275569.13
6/3/2024,6/3/2024,,11555 Pacific Aviation : Evolution Benefits ; 05/27/24 - 06/02/24,PAV,11555,,GJ,,4286.37,1271282.76
6/6/2024,6/6/2024,,11555 Pacific Aviation Corp; ACH: 06.05.2024 INCOMING ACH,PAV,11555,,GJ,33402.6,,1304685.36
6/10/2024,6/10/2024,,11555 Pacific Aviation : Evolution Benefits ; 06/03/24 - 06/09/24,PAV,11555,,GJ,,741.57,1303943.79
6/11/2024,6/11/2024,,11555 Pacific Aviation Corp; CHECK: 8010486365,PAV,11555,,GJ,273.28,,1304217.07
 Totals for 10PAVA - Cash : Pacific Aviation Health & Welfare,,,,,,,,4233581.2,3517068.1,1304217.07
111000 - Contributions Receivable (Balance forward As of 07/01/2023) ,,,,,,,,,,402394.13
7/14/2023,7/14/2023,820,11555 Pacific Aviation Corp; WIRE: 07.13.2023 INCOMING WIRE,PAV,11555,,OBJ,,310601.03,91793.1
7/31/2023,7/31/2023,,11555 (202307) Pacific Aviation : Contributions,PAV,11555,,AE,301115.13,,392908.23
8/30/2023,8/30/2023,963,11555 Pacific Aviation Corp; WIRE: 08.29.2023 INCOMING WIRE,PAV,11555,,OBJ,,234975.47,157932.76
8/31/2023,8/31/2023,,11555 (202308) Pacific Aviation : Contributions,PAV,11555,,AE,265262.05,,423194.81
9/12/2023,9/12/2023,995,11555 Pacific Aviation Corp; WIRE: 09.11.2023 INCOMING WIRE,PAV,11555,,OBJ,,265262.05,157932.76
9/25/2023,9/25/2023,1043,11555 Pacific Aviation Corp; ACH: 09.22.2023 INCOMING ACH,PAV,11555,,OBJ,,91793.11,66139.65
10/6/2023,10/6/2023,1077,11555 Pacific Aviation Corp; ACH: 10.05.2023 INCOMING ACH,PAV,11555,,OBJ,,66139.66,-0.01
10/10/2023,10/10/2023,1101,11555 Pacific Aviation Corp; WIRE: 10.09.2023 INCOMING WIRE,PAV,11555,,OBJ,,368401.55,-368401.56
10/20/2023,10/20/2023,1135,11555 Pacific Aviation Corp; ACH: 10.19.2023 INCOMING ACH,PAV,11555,,OBJ,,278899.53,-647301.09
11/1/2023,11/1/2023,1167,11555 Pacific Aviation Corp; ACH: 10.31.2023 INCOMING ACH,PAV,11555,,OBJ,,33764.02,-681065.11
11/16/2023,11/16/2023,1205,11555 Pacific Aviation Corp; ACH: 11.15.2023 INCOMING ACH,PAV,11555,,OBJ,,391395.83,-1072460.94
1/26/2024,1/26/2024,,11555 Pacific Aviation Corp; ACH: 01.25.2024 INCOMING ACH,PAV,11555,,GJ,,33970.17,-1106431.11
1/31/2024,1/31/2024,,11555 Pacific Aviation Corp; ACH: 01.30.2024 INCOMING ACH,PAV,11555,,GJ,,255102.39,-1361533.5
2/14/2024,2/14/2024,,11555 Pacific Aviation Corp; ACH: 02.13.2024 INCOMING ACH,PAV,11555,,GJ,,305400.91,-1666934.41
2/14/2024,2/14/2024,,11555 Pacific Aviation Corp; CHECK: 6625,PAV,11555,,GJ,,3382.36,-1670316.77
2/28/2024,2/28/2024,,11555 Pacific Aviation Corp; ACH: 02.27.2024 INCOMING ACH,PAV,11555,,GJ,,32528.83,-1702845.6
3/4/2024,3/4/2024,,11555 Pacific Aviation Corp; ACH: 03.01.2024 INCOMING ACH,PAV,11555,,GJ,,94.42,-1702940.02
3/13/2024,3/13/2024,,11555 Pacific Aviation Corp; ACH: 03.12.2024 INCOMING ACH,PAV,11555,,GJ,,288194.93,-1991134.95
3/21/2024,3/21/2024,,11555 Pacific Aviation Corp; ACH: 03.20.2024 INCOMING ACH,PAV,11555,,GJ,,82376.74,-2073511.69
3/27/2024,3/27/2024,,11555 Pacific Aviation Corp; ACH: 03.26.2024 INCOMING ACH,PAV,11555,,GJ,,32348.32,-2105860.01
4/19/2024,4/19/2024,,11555 Pacific Aviation Corp; ACH: 04.18.2024 INCOMING ACH,PAV,11555,,GJ,,325667.72,-2431527.73
4/30/2024,4/30/2024,,11555 Pacific Aviation Corp; ACH: 04.29.2024 INCOMING ACH,PAV,11555,,GJ,,29987.83,-2461515.56
5/8/2024,5/8/2024,,11555 Pacific Aviation Corp; CHECK: 269,PAV,11555,,GJ,,8.18,-2461523.74
5/22/2024,5/22/2024,,11555 Pacific Aviation Corp; ACH: 05.21.2024 INCOMING ACH,PAV,11555,,GJ,,291310.64,-2752834.38
6/6/2024,6/6/2024,,11555 Pacific Aviation Corp; ACH: 06.05.2024 INCOMING ACH,PAV,11555,,GJ,,33402.6,-2786236.98
6/11/2024,6/11/2024,,11555 Pacific Aviation Corp; CHECK: 8010486365,PAV,11555,,GJ,,273.28,-2786510.26
 Totals for 111000 - Contributions Receivable,,,,,,,,566377.18,3755281.57,-2786510.26
120000 - Prepaid Expense (Balance forward As of 07/01/2023) ,,,,,,,,,,0
3/18/2024,3/18/2024,,11555 (202404) Pacific Aviation : Medical / Basic Life and AD&D,PAV,11555,,AE,,289443.11,-289443.11
3/18/2024,3/18/2024,,11555 (202404) Pacific Aviation : Medical / Basic Life and AD&D,PAV,11555,,AE,289443.11,,0
 Totals for 120000 - Prepaid Expense,,,,,,,,289443.11,289443.11,0
130000 - HRA Initial Funding (Balance forward As of 07/01/2023) ,,,,,,,,,,1650.48
 Totals for 130000 - HRA Initial Funding,,,,,,,,0,0,1650.48
140000 - (Over)/Short (Balance forward As of 07/01/2023) ,,,,,,,,,,-396257.81
7/31/2023,7/31/2023,,11555 (202307) Pacific Aviation : Over Short,PAV,11555,,AE,52226.14,,-344031.67
8/31/2023,8/31/2023,,11555 (202308) Pacific Aviation : Over Short,PAV,11555,,AE,35843.46,,-308188.21
 Totals for 140000 - (Over)/Short,,,,,,,,88069.6,0,-308188.21
200100 - Due from BC Custodial_2342 (Balance forward As of 07/01/2023) ,,,,,,,,,,0
7/3/2023,7/3/2023,783,Evolution Benefits /IN: 11555-070223-HRA 11555 Pacific Aviation : Evolution Benefits ; 06/26/23 - 07/02/23 From Comp: BGC,PAV,0,,OBJ,,2292.84,-2292.84
7/3/2023,7/3/2023,794,Doc: 703 07/03/23 11555 Pacific Aviation : Evolution Benefits ; 06/26/23 - 07/02/23,PAV,0,,OBJ,2292.84,,0
7/10/2023,7/10/2023,798,Doc: 00710 07/10/23 11555 Pacific Aviation : Evolution Benefits ; 07/03/23 - 07/09/23,PAV,0,,OBJ,366.19,,366.19
7/10/2023,7/10/2023,799,Evolution Benefits /IN: 11555-070923-HRA 11555 Pacific Aviation : Evolution Benefits ; 07/03/23 - 07/09/23 From Comp: BGC,PAV,0,,OBJ,,366.19,0
7/14/2023,7/14/2023,818,Doc: 0714MTA 07/14/23 11555 Pacific Aviation Corp; WIRE: 07.13.2023 INCOMING WIRE,PAV,0,,OBJ,,310601.03,-310601.03
7/14/2023,7/14/2023,819,11555 Pacific Aviation Corp; WIRE: 07.13.2023 INCOMING WIRE,PAV,0,,OBJ,310601.03,,0
7/19/2023,7/19/2023,823,Evolution Benefits /IN: 11555-071623-HRA 11555 Pacific Aviation : Evolution Benefits ; 07/10/23 - 07/16/23 From Comp: BGC,PAV,0,,OBJ,,1938.14,-1938.14
7/20/2023,7/20/2023,822,Doc: 00720 07/20/23 11555 Pacific Aviation : Evolution Benefits ; 07/10/23 - 07/16/23,PAV,0,,OBJ,1938.14,,0
7/24/2023,7/24/2023,826,Doc: 724 07/24/23 11555 Pacific Aviation : Evolution Benefits ; 07/17/23 - 07/23/23,PAV,0,,OBJ,990.18,,990.18
7/24/2023,7/24/2023,827,Evolution Benefits /IN: 11555-072323-HRA 11555 Pacific Aviation : Evolution Benefits ; 07/17/23 - 07/23/23 From Comp: BGC,PAV,0,,OBJ,,990.18,0
7/31/2023,7/31/2023,834,Doc: 00731 07/31/23 11555 Pacific Aviation : Evolution Benefits ; 07/24/23 - 07/30/23,PAV,0,,OBJ,1011.97,,1011.97
7/31/2023,7/31/2023,835,Evolution Benefits /IN: 11555-073023-HRA 11555 Pacific Aviation : Evolution Benefits ; 07/24/23 - 07/30/23 From Comp: BGC,PAV,0,,OBJ,,1011.97,0
8/7/2023,8/7/2023,848,Doc: 00807 08/07/23 11555 Pacific Aviation : Evolution Benefits ; 07/31/23 - 08/06/23,PAV,0,,OBJ,1388.26,,1388.26
8/7/2023,8/7/2023,849,Evolution Benefits /IN: 11555-080623-HRA 11555 Pacific Aviation : Evolution Benefits ; 07/31/23 - 08/06/23 From Comp: BGC,PAV,0,,OBJ,,1388.26,0
8/8/2023,8/8/2023,852,Doc: 0808MTA 08/08/23 11555 Pacific Aviation Corp : HRA 080123 ; Check Register 080123,PAV,0,,OBJ,200,,200
8/8/2023,8/8/2023,854,11555 Pacific Aviation Corp : HRA 080123 ; Check Register 080123,PAV,0,,OBJ,,200,0
8/14/2023,8/14/2023,862,Doc: 00814 08/14/23 11555 Pacific Aviation : Evolution Benefits ; 08/07/23 - 08/13/23,PAV,0,,OBJ,1281.15,,1281.15
8/14/2023,8/14/2023,863,Evolution Benefits /IN: 11555-081323-HRA 11555 Pacific Aviation : Evolution Benefits ; 08/07/23 - 08/13/23 From Comp: BGC,PAV,0,,OBJ,,1281.15,0
8/18/2023,8/18/2023,939,Doc: 0818 08/18/23 11555 (202306) Pacific Aviation : Boon Trust Fees,PAV,0,,OBJ,13322,,13322
8/18/2023,8/18/2023,943,Boon Administrative Services /IN: 11555-202306-PREM 11555 (202306) Pacific Aviation : Boon Trust Fees From Comp: BGC,PAV,0,,OBJ,,13322,0
8/21/2023,8/21/2023,941,Doc: 00821 08/21/23 11555 Pacific Aviation : Evolution Benefits ; 08/14/23 - 08/20/23,PAV,0,,OBJ,1308.16,,1308.16
8/21/2023,8/21/2023,944,Evolution Benefits /IN: 11555-082023-HRA 11555 Pacific Aviation : Evolution Benefits ; 08/14/23 - 08/20/23 From Comp: BGC,PAV,0,,OBJ,,1308.16,0
8/28/2023,8/28/2023,953,Doc: 00829 08/28/23 11555 Pacific Aviation : Evolution Benefits ; MM/DD/YY - MM/DD/YY,PAV,0,,OBJ,319.97,,319.97
8/28/2023,8/28/2023,954,Evolution Benefits /IN: 11555-082023-HRA 11555 Pacific Aviation : Evolution Benefits ; 08/21/23 - 08/27/23 From Comp: BGC,PAV,0,,OBJ,,319.97,0
8/30/2023,8/30/2023,962,11555 Pacific Aviation Corp; WIRE: 08.29.2023 INCOMING WIRE,PAV,0,,OBJ,234975.47,,234975.47
8/30/2023,8/30/2023,965,Doc: 0830MPA 08/30/23 11555 Pacific Aviation Corp; WIRE: 08.29.2023 INCOMING WIRE,PAV,0,,OBJ,,234975.47,0
8/31/2023,8/31/2023,979,Doc: 0831 08/31/23 11555 (202307) Pacific Aviation : Boon Trust Fees,PAV,0,,OBJ,15381,,15381
8/31/2023,8/31/2023,983,Boon Administrative Services /IN: 11555-202307-PREM 11555 (202307) Pacific Aviation : Boon Trust Fees From Comp: BGC,PAV,0,,OBJ,,15381,0
9/5/2023,9/5/2023,981,Doc: 00905 09/05/23 11555 Pacific Aviation : Evolution Benefits ; 08/28/23 - 09/03/23,PAV,0,,OBJ,2199.06,,2199.06
9/5/2023,9/5/2023,984,Evolution Benefits /IN: 11555-090323-HRA 11555 Pacific Aviation : Evolution Benefits ; 08/28/23 - 09/03/23 From Comp: BGC,PAV,0,,OBJ,,2199.06,0
9/11/2023,9/11/2023,993,Doc: 00911 09/11/23 11555 Pacific Aviation : Evolution Benefits ; 09/04/23 - 09/10/23,PAV,0,,OBJ,1761.79,,1761.79
9/11/2023,9/11/2023,1004,Evolution Benefits /IN: 11555-091023-HRA 11555 Pacific Aviation : Evolution Benefits ; 09/04/23 - 09/10/23 From Comp: BGC,PAV,0,,OBJ,,1761.79,0
9/12/2023,9/12/2023,994,11555 Pacific Aviation Corp; WIRE: 09.11.2023 INCOMING WIRE,PAV,0,,OBJ,265262.05,,265262.05
9/12/2023,9/12/2023,997,Doc: 0912MPA 09/12/23 11555 Pacific Aviation Corp; WIRE: 09.11.2023 INCOMING WIRE,PAV,0,,OBJ,,265262.05,0
9/15/2023,9/15/2023,999,Doc: 0915 09/15/23 11555 (202304) Pacific Aviation : HRA Debit Card Fee,PAV,0,,OBJ,20,,20
9/15/2023,9/15/2023,1001,Doc: 0915 09/15/23 11555 (202305) Pacific Aviation : HRA Debit Card Fee,PAV,0,,OBJ,40,,60
9/15/2023,9/15/2023,1003,Doc: 0915 09/15/23 11555 (202306) Pacific Aviation : HRA Debit Card Fee,PAV,0,,OBJ,30,,90
9/15/2023,9/15/2023,1009,Boon Administrative Services /IN: 11555-202304-BAS 11555 (202304) Pacific Aviation : HRA Debit Card Fee From Comp: BGC,PAV,0,,OBJ,,20,70
9/15/2023,9/15/2023,1010,Boon Administrative Services /IN: 11555-202305-BAS 11555 (202305) Pacific Aviation : HRA Debit Card Fee From Comp: BGC,PAV,0,,OBJ,,40,30
9/15/2023,9/15/2023,1011,Boon Administrative Services /IN: 11555-202306-BAS 11555 (202306) Pacific Aviation : HRA Debit Card Fee From Comp: BGC,PAV,0,,OBJ,,30,0
9/15/2023,9/15/2023,1087,Doc: 0915 09/15/23 11555 (202304) Pacific Aviation : HRA Debit Card Fee,PAV,0,,OBJ,,20,-20
9/15/2023,9/15/2023,1089,Doc: 0915 09/15/23 11555 (202305) Pacific Aviation : HRA Debit Card Fee,PAV,0,,OBJ,,40,-60
9/15/2023,9/15/2023,1091,Doc: 0915 09/15/23 11555 (202306) Pacific Aviation : HRA Debit Card Fee,PAV,0,,OBJ,,30,-90
9/15/2023,9/15/2023,1093,Doc: 0915 09/15/23 11555 (202304) Pacific Aviation : HRA Debit Card Fee,PAV,0,,OBJ,20,,-70
9/15/2023,9/15/2023,1095,Doc: 0915 09/15/23 11555 (202305) Pacific Aviation : HRA Debit Card Fee,PAV,0,,OBJ,40,,-30
9/15/2023,9/15/2023,1097,Doc: 0915 09/15/23 11555 (202306) Pacific Aviation : HRA Debit Card Fee,PAV,0,,OBJ,30,,0
9/18/2023,9/18/2023,1012,Evolution Benefits /IN: 11555-091723-HRA 11555 Pacific Aviation : Evolution Benefits ; 09/11/23 - 09/17/23 From Comp: BGC,PAV,0,,OBJ,,1476.19,-1476.19
9/18/2023,9/18/2023,1015,Doc: 00918 09/18/23 11555 Pacific Aviation : Evolution Benefits ; 09/11/23 - 09/17/23,PAV,0,,OBJ,1476.19,,0
9/25/2023,9/25/2023,1042,11555 Pacific Aviation Corp; ACH: 09.22.2023 INCOMING ACH,PAV,0,,OBJ,91793.11,,91793.11
9/25/2023,9/25/2023,1045,Doc: 0925MPA 09/25/23 11555 Pacific Aviation Corp; ACH: 09.22.2023 INCOMING ACH,PAV,0,,OBJ,,91793.11,0
9/25/2023,9/25/2023,1047,Doc: 925 09/25/23 11555 Pacific Aviation : Evolution Benefits ; 09/18/23 - 09/24/23,PAV,0,,OBJ,4497.61,,4497.61
9/25/2023,9/25/2023,1048,Evolution Benefits /IN: 11555-092423-HRA 11555 Pacific Aviation : Evolution Benefits ; 09/18/23 - 09/24/23 From Comp: BGC,PAV,0,,OBJ,,4497.61,0
9/29/2023,9/29/2023,1052,11555 (202306) Pacific Aviation : Bank Fee,PAV,0,,OBJ,250,,250
9/29/2023,9/29/2023,1055,Doc: 0929USA 09/29/23 11555 (202306) Pacific Aviation : Bank Fee,PAV,0,,OBJ,,250,0
9/29/2023,9/29/2023,1057,Doc: 929 09/29/23 11555 (202308) Pacific Aviation : Boon Trust Fees,PAV,0,,OBJ,14685,,14685
9/29/2023,9/29/2023,1061,Boon Administrative Services /IN: 11555-202308-PREM 11555 (202308) Pacific Aviation : Boon Trust Fees From Comp: BGC,PAV,0,,OBJ,,14685,0
9/29/2023,9/29/2023,1063,Boon Administrative Services /IN: 11555-202306-BANKFEE 11555 (202306) Pacific Aviation : Bank Fee From Comp: BGC,PAV,0,,OBJ,250,,250
9/29/2023,9/29/2023,1065,Boon Administrative Services /IN: 11555-202306-BANKFEE 11555 (202306) Pacific Aviation : Bank Fee From Comp: BGC,PAV,0,,OBJ,,250,0
9/29/2023,9/29/2023,1067,Boon Administrative Services /IN: 11555-202306-BANKFEE 11555 (202306) Pacific Aviation : Bank Fee From Comp: BGC,PAV,0,,OBJ,,250,-250
9/30/2023,9/30/2023,1084,11555 (202306) Pacific Aviation : Bank Fee,PAV,0,,OBJ,250,,0
10/2/2023,10/2/2023,1068,Evolution Benefits /IN: 11555-100123-HRA 11555 Pacific Aviation : Evolution Benefits ; 09/25/23 - 10/01/23 From Comp: BGC,PAV,0,,OBJ,,1981.8,-1981.8
10/2/2023,10/2/2023,1157,Doc: 1002 10/02/23 11555 Pacific Aviation : Evolution Benefits ; 09/25/23 - 10/01/23,PAV,0,,OBJ,1981.8,,0
10/4/2023,10/4/2023,1070,11555 Pacific Aviation : HRA 100223 ; Check Register 100223,PAV,0,,OBJ,400,,400
10/4/2023,10/4/2023,1073,Doc: 1003MPA 10/04/23 11555 Pacific Aviation : HRA 100223 ; Check Register 100223,PAV,0,,OBJ,,400,0
10/6/2023,10/6/2023,1075,Doc: 1006MPA 10/06/23 11555 Pacific Aviation Corp; ACH: 10.05.2023 INCOMING ACH,PAV,0,,OBJ,,66139.66,-66139.66
10/6/2023,10/6/2023,1076,11555 Pacific Aviation Corp; ACH: 10.05.2023 INCOMING ACH,PAV,0,,OBJ,66139.66,,0
10/10/2023,10/10/2023,1100,11555 Pacific Aviation Corp; WIRE: 10.09.2023 INCOMING WIRE,PAV,0,,OBJ,368401.55,,368401.55
10/10/2023,10/10/2023,1103,11555 Pacific Aviation : HRA 100223 ; Check Register 100223,PAV,0,,OBJ,,600,367801.55
10/10/2023,10/10/2023,1105,Doc: 1010MPA 10/10/23 11555 Pacific Aviation Corp; WIRE: 10.09.2023 INCOMING WIRE,PAV,0,,OBJ,,368401.55,-600
10/10/2023,10/10/2023,1107,Doc: 01010 10/10/23 11555 Pacific Aviation : Evolution Benefits ; 10/02/23 - 10/08/23,PAV,0,,OBJ,1171.6,,571.6
10/10/2023,10/10/2023,1109,Doc: 1010MPA 10/10/23 11555 Pacific Aviation : HRA 100223 ; Check Register 100223,PAV,0,,OBJ,600,,1171.6
10/10/2023,10/10/2023,1110,Evolution Benefits /IN: 11555-100823-HRA 11555 Pacific Aviation : Evolution Benefits ; 10/02/23 - 10/08/23 From Comp: BGC,PAV,0,,OBJ,,1171.6,0
10/16/2023,10/16/2023,1114,Evolution Benefits /IN: 11555-101523-HRA 11555 Pacific Aviation : Evolution Benefits ; 10/09/23 - 10/15/23 From Comp: BGC,PAV,0,,OBJ,,969.76,-969.76
10/16/2023,10/16/2023,1121,Doc: 01016 10/16/23 11555 Pacific Aviation : Evolution Benefits ; 10/09/23 - 10/15/23,PAV,0,,OBJ,969.76,,0
10/17/2023,10/17/2023,1123,11555 Pacific Aviation : HRA 101123 ; Check Register 101123,PAV,0,,OBJ,,228.78,-228.78
10/17/2023,10/17/2023,1125,Doc: 1017MPA 10/17/23 11555 Pacific Aviation : HRA 101123 ; Check Register 101123,PAV,0,,OBJ,228.78,,0
10/20/2023,10/20/2023,1134,11555 Pacific Aviation Corp; ACH: 10.19.2023 INCOMING ACH,PAV,0,,OBJ,278899.53,,278899.53
10/20/2023,10/20/2023,1137,Doc: 1020MTA 10/20/23 11555 Pacific Aviation Corp; ACH: 10.19.2023 INCOMING ACH,PAV,0,,OBJ,,278899.53,0
10/24/2023,10/24/2023,1141,Doc: 01024 10/24/23 11555 Pacific Aviation : Evolution Benefits ; 10/16/23 - 10/22/23,PAV,0,,OBJ,2391.34,,2391.34
10/24/2023,10/24/2023,1142,Evolution Benefits /IN: 11555-102223-HRA 11555 Pacific Aviation : Evolution Benefits ; 10/16/23 - 10/22/23 From Comp: BGC,PAV,0,,OBJ,,2391.34,0
10/25/2023,10/25/2023,1147,11555 Pacific Aviation : HRA 101823 ; Check Register 101823,PAV,0,,OBJ,,246.36,-246.36
10/25/2023,10/25/2023,1149,Doc: 1025MPA 10/25/23 11555 Pacific Aviation : HRA 101823 ; Check Register 101823,PAV,0,,OBJ,246.36,,0
10/30/2023,10/30/2023,1151,Doc: 01030 10/30/23 11555 Pacific Aviation : Evolution Benefits ; 10/23/23 - 10/29/23,PAV,0,,OBJ,1108.29,,1108.29
10/30/2023,10/30/2023,1162,Evolution Benefits /IN: 11555-102923-HRA 11555 Pacific Aviation : Evolution Benefits ; 10/23/23 - 10/29/23 From Comp: BGC,PAV,0,,OBJ,,1108.29,0
10/31/2023,10/31/2023,1153,11555 Pacific Aviation : HRA 102523 ; Check Register 102523,PAV,0,,OBJ,,762.22,-762.22
10/31/2023,10/31/2023,1155,Doc: 1031MPA 10/31/23 11555 Pacific Aviation : HRA 102523 ; Check Register 102523,PAV,0,,OBJ,762.22,,0
11/1/2023,11/1/2023,1166,11555 Pacific Aviation Corp; ACH: 10.31.2023 INCOMING ACH,PAV,0,,OBJ,33764.02,,33764.02
11/1/2023,11/1/2023,1169,Doc: 1101GNA 11/01/23 11555 Pacific Aviation Corp; ACH: 10.31.2023 INCOMING ACH,PAV,0,,OBJ,,33764.02,0
11/6/2023,11/6/2023,1171,Doc: 01106 11/06/23 11555 Pacific Aviation : Evolution Benefits ; 10/30/23 - 11/05/23,PAV,0,,OBJ,3344.12,,3344.12
11/6/2023,11/6/2023,1172,Evolution Benefits /IN: 11555-110523-HRA 11555 Pacific Aviation : Evolution Benefits ; 10/30/23 - 11/05/23 From Comp: BGC,PAV,0,,OBJ,,3344.12,0
11/13/2023,11/13/2023,1192,Evolution Benefits /IN: 11555-111223-HRA 11555 Pacific Aviation : Evolution Benefits ; 11/06/23 - 11/12/23 From Comp: BGC,PAV,0,,OBJ,,3256.47,-3256.47
11/13/2023,11/13/2023,1195,Doc: 1113 11/13/23 11555 Pacific Aviation : Evolution Benefits ; 11/06/23 - 11/12/23,PAV,0,,OBJ,3256.47,,0
11/15/2023,11/15/2023,1203,Doc: 1115 11/15/23 11555 (202309) Pacific Aviation : Boon Trust Fees,PAV,0,,OBJ,16831,,16831
11/15/2023,11/15/2023,1211,Boon Administrative Services /IN: 11555-202306-BANKFEE 11555 (202306) Pacific Aviation : Bank Fee From Comp: BGC,PAV,0,,OBJ,250,,17081
11/15/2023,11/15/2023,1212,Boon Administrative Services /IN: 11555-202306-BNKFEE2 11555 (202306) Pacific Aviation : Bank Fee From Comp: BGC,PAV,0,,OBJ,250,,17331
11/15/2023,11/15/2023,1213,Boon Administrative Services /IN: 11555-202309-PREM 11555 (202309) Pacific Aviation : Boon Trust Fees From Comp: BGC,PAV,0,,OBJ,,16831,500
11/16/2023,11/16/2023,1204,11555 Pacific Aviation Corp; ACH: 11.15.2023 INCOMING ACH,PAV,0,,OBJ,391395.83,,391895.83
11/16/2023,11/16/2023,1207,Doc: 1116MPA 11/16/23 11555 Pacific Aviation Corp; ACH: 11.15.2023 INCOMING ACH,PAV,0,,OBJ,,391395.83,500
11/20/2023,11/20/2023,1215,Doc: 01120 11/20/23 11555 Pacific Aviation : Evolution Benefits ; 11/13/23 - 11/19/23,PAV,0,,OBJ,4124.49,,4624.49
11/20/2023,11/20/2023,1216,Evolution Benefits /IN: 11555-111923-HRA 11555 Pacific Aviation : Evolution Benefits ; 11/13/23 - 11/19/23 From Comp: BGC,PAV,0,,OBJ,,4124.49,500
11/21/2023,11/21/2023,1226,Boon Administrative Services /IN: 11555-202306-BANKFEE BGC INV: 11555-202306-BANKFEE From Comp: BGC,PAV,0,,OBJ,,250,250
11/21/2023,11/21/2023,1227,Boon Administrative Services /IN: 11555-202306-BNKFEE2 BGC INV: 11555-202306-BNKFEE2 From Comp: BGC,PAV,0,,OBJ,,250,0
11/27/2023,11/27/2023,1229,Doc: 01127 11/27/23 11555 Pacific Aviation : Evolution Benefits ; 11/20/23 - 11/26/23,PAV,0,,OBJ,4985.92,,4985.92
11/27/2023,11/27/2023,1230,Evolution Benefits /IN: 11555-112623-HRA 11555 Pacific Aviation : Evolution Benefits ; 11/20/23 - 11/26/23 From Comp: BGC,PAV,0,,OBJ,,4985.92,0
11/29/2023,11/29/2023,1232,11189 (202310) CoreCivic : 10.25.23 HRA manual check paid from PAV,PAV,0,,OBJ,246.36,,246.36
11/29/2023,11/29/2023,1234,11189 (202310) CoreCivic : 10.31.23 HRA manual check paid from PAV,PAV,0,,OBJ,762.22,,1008.58
11/29/2023,11/29/2023,1237,Doc: 1129MTA 11/29/23 11189 (202310) CoreCivic : 10.25.23 HRA manual check paid from PAV,PAV,0,,OBJ,,246.36,762.22
11/29/2023,11/29/2023,1239,Doc: 1129MTA 11/29/23 11189 (202310) CoreCivic : 10.31.23 HRA manual check paid from PAV,PAV,0,,OBJ,,762.22,0
 Totals for 200100 - Due from BC Custodial_2342,,,,,,,,2150492.49,2150492.49,0
200200 - Due from CST_1860 (Balance forward As of 07/01/2023) ,,,,,,,,,,0
7/3/2023,7/3/2023,785,Kaiser Foundation Health Plan of WA /IN: 11555-202306-PREM 11555 (202306) Pacific Aviation Corporation : Medical From Comp: CST,PAV,0,,OBJ,,793.86,-793.86
7/3/2023,7/3/2023,787,Kaiser Foundation Health Plan of WA /IN: 11555-202306-PREM 11555 (202306) Pacific Aviation Corporation : Medical From Comp: CST,PAV,0,,OBJ,793.86,,0
7/3/2023,7/3/2023,789,Kaiser Foundation Health Plan of WA /IN: 11555-202306-PREM 11555 (202306) Pacific Aviation Corporation : Medical From Comp: CST,PAV,0,,OBJ,,793.86,-793.86
7/3/2023,7/3/2023,796,Doc: 00703 07/03/23 11555 (202306) Pacific Aviation Corporation : Medical,PAV,0,,OBJ,793.86,,0
7/12/2023,7/12/2023,810,Doc: 00712 07/12/23 11555 (202307) Pacific Aviation Corporation : Medical,PAV,0,,OBJ,912.94,,912.94
7/12/2023,7/12/2023,812,Doc: 00712 07/12/23 11555 (202306) Pacific Aviation Corporation : Medical/Basic Life and AD&D,PAV,0,,OBJ,204615.69,,205528.63
7/12/2023,7/12/2023,813,Empire Health Choice Assurance /IN: 11555-202306-PREM1 11555 (202306) Pacific Aviation Corporation : Medical/Basic Life and AD&D From Comp: CST,PAV,0,,OBJ,,204615.69,912.94
7/12/2023,7/12/2023,814,Kaiser Foundation Health Plan of WA /IN: 11555-202307-PREM 11555 (202307) Pacific Aviation Corporation : Medical From Comp: CST,PAV,0,,OBJ,,912.94,0
8/2/2023,8/2/2023,838,"Doc: 00802 08/02/23 11555 (202306) Pacific Aviation : Dental, Vision, Ancillary",PAV,0,,OBJ,10171.33,,10171.33
8/2/2023,8/2/2023,840,Doc: 00802 08/02/23 11555 (202306) Pacific Aviation : Anthem HAS,PAV,0,,OBJ,120,,10291.33
8/2/2023,8/2/2023,843,"MetLife /IN: 11555-202306-PREM 11555 (202306) Pacific Aviation : Dental, Vision, Ancillary From Comp: CST",PAV,0,,OBJ,,10171.33,120
8/2/2023,8/2/2023,844,Retirement 401K CST /IN: 11555-202306-PREM 11555 (202306) Pacific Aviation : Anthem HAS From Comp: CST,PAV,0,,OBJ,,120,0
8/30/2023,8/30/2023,956,Retirement 401K CST /IN: 11555-202307-PREM 11555 (202307) Pacific Aviation Corporation : Anthem HSA Contributions From Comp: CST,PAV,0,,OBJ,,265.38,-265.38
8/30/2023,8/30/2023,957,Empire Health Choice Assurance /IN: 11555-202308-PREM2 11555 (202308) Pacific Aviation Corporation : Medical / Basic Life and AD&D From Comp: CST,PAV,0,,OBJ,,235992.47,-236257.85
8/30/2023,8/30/2023,958,"MetLife /IN: 11555-202307-PREM1 11555 (202307) Pacific Aviation Corporation : Dental, Vision, and Ancillary Benefits From Comp: CST",PAV,0,,OBJ,,13550.43,-249808.28
8/30/2023,8/30/2023,967,Doc: 00830 08/30/23 11555 (202307) Pacific Aviation Corporation : Anthem HSA Contributions,PAV,0,,OBJ,265.38,,-249542.9
8/30/2023,8/30/2023,969,"Doc: 00830 08/30/23 11555 (202307) Pacific Aviation Corporation : Dental, Vision, and Ancillary Benefits",PAV,0,,OBJ,13550.43,,-235992.47
8/30/2023,8/30/2023,971,Doc: 00830 08/30/23 11555 (202308) Pacific Aviation Corporation : Medical / Basic Life and AD&D,PAV,0,,OBJ,235992.47,,0
9/20/2023,9/20/2023,1017,Doc: 00920 09/20/23 11555 (202308) Pacific Aviation Corporation : Anthem HSA Contributions,PAV,0,,OBJ,235.38,,235.38
9/20/2023,9/20/2023,1019,Doc: 00920 09/20/23 11555 (202308) Pacific Aviation Corporation : Medical,PAV,0,,OBJ,912.94,,1148.32
9/20/2023,9/20/2023,1021,Doc: 00920 09/20/23 11555 (202308) Pacific Aviation Corporation : Dental Vision and Ancilliary Benefits,PAV,0,,OBJ,13156.26,,14304.58
9/20/2023,9/20/2023,1023,Doc: 00920 09/20/23 11555 (202309) Pacific Aviation Corporation : Medical / Basic Life and AD&D,PAV,0,,OBJ,336928.46,,351233.04
9/20/2023,9/20/2023,1025,Doc: 00920 09/20/23 11555 (202309) Pacific Aviation Corporation : Medical,PAV,0,,OBJ,912.94,,352145.98
9/20/2023,9/20/2023,1032,Kaiser Foundation Health Plan of WA /IN: 11555-202308-PREM1 11555 (202308) Pacific Aviation Corporation : Medical From Comp: CST,PAV,0,,OBJ,,912.94,351233.04
9/20/2023,9/20/2023,1033,Kaiser Foundation Health Plan of WA /IN: 11555-202309-PREM4 11555 (202309) Pacific Aviation Corporation : Medical From Comp: CST,PAV,0,,OBJ,,912.94,350320.1
9/20/2023,9/20/2023,1034,MetLife /IN: 11555-202308-PREM2 11555 (202308) Pacific Aviation Corporation : Dental Vision and Ancilliary Benefits From Comp: CST,PAV,0,,OBJ,,13156.26,337163.84
9/20/2023,9/20/2023,1035,Retirement 401K CST /IN: 11555-202308-PREM 11555 (202308) Pacific Aviation Corporation : Anthem HSA Contributions From Comp: CST,PAV,0,,OBJ,,235.38,336928.46
9/20/2023,9/20/2023,1036,Empire Health Choice Assurance /IN: 11555-202309-PREM3 11555 (202309) Pacific Aviation Corporation : Medical / Basic Life and AD&D From Comp: CST,PAV,0,,OBJ,,336928.46,0
9/28/2023,9/28/2023,1051,Doc: 00928 09/28/23 11555 (202310) Pacific Aviation Corporation : Medical,PAV,0,,OBJ,1369.41,,1369.41
9/28/2023,9/28/2023,1058,Kaiser Foundation Health Plan of WA /IN: 11555-202310-PREM 11555 (202310) Pacific Aviation Corporation : Medical From Comp: CST,PAV,0,,OBJ,,1369.41,0
10/10/2023,10/10/2023,1099,Doc: 01010 10/10/23 11555 (202310) Pacific Aviation Corporation : Medical,PAV,0,,OBJ,456.47,,456.47
10/10/2023,10/10/2023,1112,Kaiser Foundation Health Plan of WA /IN: 11555-202310-PREM 11555 (202310) Pacific Aviation Corporation : Medical From Comp: CST,PAV,0,,OBJ,,456.47,0
10/17/2023,10/17/2023,1116,Empire Health Choice Assurance /IN: 11555-202303-PREM 11555 (202303) Pacific Aviation Corporation : Medical/ Basic Life and AD&D From Comp: CST,PAV,0,,OBJ,,1491.79,-1491.79
10/17/2023,10/17/2023,1117,Empire Health Choice Assurance /IN: 11555-202310-PREM1 11555 (202310) Pacific Aviation Corporation : Medical/ Basic Life and AD&D From Comp: CST,PAV,0,,OBJ,,246286.86,-247778.65
10/17/2023,10/17/2023,1131,Doc: 01017 10/17/23 11555 (202303) Pacific Aviation Corporation : Medical/ Basic Life and AD&D,PAV,0,,OBJ,1491.79,,-246286.86
10/17/2023,10/17/2023,1133,Doc: 01017 10/17/23 11555 (202310) Pacific Aviation Corporation : Medical/ Basic Life and AD&D,PAV,0,,OBJ,246286.86,,0
10/24/2023,10/24/2023,1139,Doc: 01024 10/24/23 11555 (202311) Pacific Aviation Corporation : Medical,PAV,0,,OBJ,1369.41,,1369.41
10/24/2023,10/24/2023,1144,Kaiser Foundation Health Plan of WA /IN: 11555-202311-PREM 11555 (202311) Pacific Aviation Corporation : Medical From Comp: CST,PAV,0,,OBJ,,1369.41,0
10/31/2023,10/31/2023,1161,Doc: 01031 10/31/23 11555 (202310) Pacific Aviation Corporation : Anthem HSA Contributions,PAV,0,,OBJ,470.76,,470.76
10/31/2023,10/31/2023,1164,Retirement 401K CST /IN: 11555-202310-PREM 11555 (202310) Pacific Aviation Corporation : Anthem HSA Contributions From Comp: CST,PAV,0,,OBJ,,470.76,0
11/7/2023,11/7/2023,1177,"Doc: 01107 11/07/23 11555 (202309) Pacific Aviation : Dental, Vision and Acilliary Benefits",PAV,0,,OBJ,13243.79,,13243.79
11/7/2023,11/7/2023,1178,"MetLife /IN: 11555-202309-PREM 11555 (202309) Pacific Aviation : Dental, Vision and Acilliary Benefits From Comp: CST",PAV,0,,OBJ,,13243.79,0
11/8/2023,11/8/2023,1183,"Doc: 01108 11/08/23 11555 (202310) Pacific Aviation : Dental, Vision and Ancilliary Benefits",PAV,0,,OBJ,14137.42,,14137.42
11/8/2023,11/8/2023,1184,"MetLife /IN: 11555-202310-PREM 11555 (202310) Pacific Aviation : Dental, Vision and Ancilliary Benefits From Comp: CST",PAV,0,,OBJ,,14137.42,0
11/14/2023,11/14/2023,1197,Doc: 01114 11/14/23 11555 (202311) Pacific Aviation Corporation : Medical / Basic Life and AD&D,PAV,0,,OBJ,358688.63,,358688.63
11/14/2023,11/14/2023,1200,Empire Health Choice Assurance /IN: 11555-202311-PREM 11555 (202311) Pacific Aviation Corporation : Medical / Basic Life and AD&D From Comp: CST,PAV,0,,OBJ,,358688.63,0
11/21/2023,11/21/2023,1219,"Doc: 01121 11/21/23 11555 (202311) Pacific Aviation : Dental, Vision, and Ancilliary Benefits",PAV,0,,OBJ,14137.42,,14137.42
11/21/2023,11/21/2023,1222,"MetLife /IN: 11555-202311-PREM 11555 (202311) Pacific Aviation : Dental, Vision, and Ancilliary Benefits From Comp: CST",PAV,0,,OBJ,,14137.42,0
 Totals for 200200 - Due from CST_1860,,,,,,,,1471013.9,1471013.9,0
210000 - General Accounts Payable (Balance forward As of 07/01/2023) ,,,,,,,,,,-24247.2
7/3/2023,7/3/2023,786,Kaiser Foundation Health Plan of WA /IN: 11555-202306-PREM 11555 (202306) Pacific Aviation Corporation : Medical From Comp: CST,PAV,11555,,OBJ,793.86,,-23453.34
7/3/2023,7/3/2023,788,Kaiser Foundation Health Plan of WA /IN: 11555-202306-PREM 11555 (202306) Pacific Aviation Corporation : Medical From Comp: CST,PAV,11555,,OBJ,,793.86,-24247.2
7/3/2023,7/3/2023,790,Kaiser Foundation Health Plan of WA /IN: 11555-202306-PREM 11555 (202306) Pacific Aviation Corporation : Medical From Comp: CST,PAV,11555,,OBJ,793.86,,-23453.34
7/12/2023,7/12/2023,807,11555 (202307) Pacific Aviation Corporation : Medical/Basic Life and AD&D,PAV,11555,,OBJ,,204615.69,-228069.03
7/12/2023,7/12/2023,815,Empire Health Choice Assurance /IN: 11555-202306-PREM1 11555 (202306) Pacific Aviation Corporation : Medical/Basic Life and AD&D From Comp: CST,PAV,11555,,OBJ,204615.69,,-23453.34
7/12/2023,7/12/2023,816,Kaiser Foundation Health Plan of WA /IN: 11555-202307-PREM 11555 (202307) Pacific Aviation Corporation : Medical From Comp: CST,PAV,11555,,OBJ,912.94,,-22540.4
7/31/2023,7/31/2023,,11555 (202307) Pacific Aviation : HRA Debit Card Fee,PAV,11555,,AE,,40,-22580.4
7/31/2023,7/31/2023,,11555 (202307) Pacific Aviation : HSA Fee,PAV,11555,,AE,,265.38,-22845.78
7/31/2023,7/31/2023,,11555 (202307) Pacific Aviation : Kaiser Medical,PAV,11555,,AE,,912.94,-23758.72
7/31/2023,7/31/2023,,11555 (202307) Pacific Aviation : MetLife Dental & Vision,PAV,11555,,AE,,7044.62,-30803.34
7/31/2023,7/31/2023,,"11555 (202307) Pacific Aviation : MetLife Life, CI, Acc, Hosp",PAV,11555,,AE,,5047.25,-35850.59
7/31/2023,7/31/2023,,11555 (202307) Pacific Aviation : MetLife STD & LTD,PAV,11555,,AE,,1458.56,-37309.15
7/31/2023,7/31/2023,,11555 (202307) Pacific Aviation : Trust Fees,PAV,11555,,AE,,15381,-52690.15
8/2/2023,8/2/2023,841,"11555 (202306) Pacific Aviation : Dental, Vision, Ancillary",PAV,11555,,OBJ,,10171.33,-62861.48
8/2/2023,8/2/2023,845,"MetLife /IN: 11555-202306-PREM 11555 (202306) Pacific Aviation : Dental, Vision, Ancillary From Comp: CST",PAV,11555,,OBJ,10171.33,,-52690.15
8/2/2023,8/2/2023,846,Retirement 401K CST /IN: 11555-202306-PREM 11555 (202306) Pacific Aviation : Anthem HAS From Comp: CST,PAV,11555,,OBJ,120,,-52570.15
8/18/2023,8/18/2023,942,Boon Administrative Services /IN: 11555-202306-PREM 11555 (202306) Pacific Aviation : Boon Trust Fees From Comp: BGC,PAV,11555,,OBJ,13322,,-39248.15
8/30/2023,8/30/2023,959,Retirement 401K CST /IN: 11555-202307-PREM 11555 (202307) Pacific Aviation Corporation : Anthem HSA Contributions From Comp: CST,PAV,11555,,OBJ,265.38,,-38982.77
8/30/2023,8/30/2023,960,Empire Health Choice Assurance /IN: 11555-202308-PREM2 11555 (202308) Pacific Aviation Corporation : Medical / Basic Life and AD&D From Comp: CST,PAV,11555,,OBJ,235992.47,,197009.7
8/30/2023,8/30/2023,961,"MetLife /IN: 11555-202307-PREM1 11555 (202307) Pacific Aviation Corporation : Dental, Vision, and Ancillary Benefits From Comp: CST",PAV,11555,,OBJ,13550.43,,210560.13
8/30/2023,8/30/2023,972,11555 (202307) Pacific Aviation Corporation : Anthem HSA Contributions,PAV,11555,,OBJ,,265.38,210294.75
8/30/2023,8/30/2023,974,"11555 (202307) Pacific Aviation Corporation : Dental, Vision, and Ancillary Benefits",PAV,11555,,OBJ,,13550.43,196744.32
8/30/2023,8/30/2023,976,11555 (202308) Pacific Aviation Corporation : Medical / Basic Life and AD&D,PAV,11555,,OBJ,,235992.47,-39248.15
8/31/2023,8/31/2023,982,Boon Administrative Services /IN: 11555-202307-PREM 11555 (202307) Pacific Aviation : Boon Trust Fees From Comp: BGC,PAV,11555,,OBJ,15381,,-23867.15
8/31/2023,8/31/2023,,11555 (202306) Pacific Aviation : MetLife Dental & Vision,PAV,11555,,AE,5310.59,,-18556.56
8/31/2023,8/31/2023,,"11555 (202306) Pacific Aviation : MetLife Life, CI, Acc, Hosp",PAV,11555,,AE,3682.75,,-14873.81
8/31/2023,8/31/2023,,11555 (202306) Pacific Aviation : MetLife STD & LTD,PAV,11555,,AE,1178,,-13695.81
8/31/2023,8/31/2023,,11555 (202307) Pacific Aviation : HSA Fee,PAV,11555,,AE,265.38,,-13430.43
8/31/2023,8/31/2023,,11555 (202307) Pacific Aviation : MetLife Dental & Vision,PAV,11555,,AE,7044.62,,-6385.81
8/31/2023,8/31/2023,,"11555 (202307) Pacific Aviation : MetLife Life, CI, Acc, Hosp",PAV,11555,,AE,5047.25,,-1338.56
8/31/2023,8/31/2023,,11555 (202307) Pacific Aviation : MetLife STD & LTD,PAV,11555,,AE,1458.56,,120
8/31/2023,8/31/2023,,11555 (202308) Pacific Aviation : HSA Fee,PAV,11555,,AE,,235.38,-115.38
8/31/2023,8/31/2023,,11555 (202308) Pacific Aviation : Kaiser Medical,PAV,11555,,AE,,912.94,-1028.32
8/31/2023,8/31/2023,,11555 (202308) Pacific Aviation : MetLife Dental & Vision,PAV,11555,,AE,,6852.39,-7880.71
8/31/2023,8/31/2023,,"11555 (202308) Pacific Aviation : MetLife Life, CI, Acc, Hosp",PAV,11555,,AE,,4858.08,-12738.79
8/31/2023,8/31/2023,,11555 (202308) Pacific Aviation : MetLife STD & LTD,PAV,11555,,AE,,1445.8,-14184.59
8/31/2023,8/31/2023,,11555 (202308) Pacific Aviation : Trust Fees,PAV,11555,,AE,,14685,-28869.59
9/15/2023,9/15/2023,1006,Boon Administrative Services /IN: 11555-202304-BAS 11555 (202304) Pacific Aviation : HRA Debit Card Fee From Comp: BGC,PAV,11555,,OBJ,20,,-28849.59
9/15/2023,9/15/2023,1007,Boon Administrative Services /IN: 11555-202305-BAS 11555 (202305) Pacific Aviation : HRA Debit Card Fee From Comp: BGC,PAV,11555,,OBJ,40,,-28809.59
9/15/2023,9/15/2023,1008,Boon Administrative Services /IN: 11555-202306-BAS 11555 (202306) Pacific Aviation : HRA Debit Card Fee From Comp: BGC,PAV,11555,,OBJ,30,,-28779.59
9/20/2023,9/20/2023,1026,11555 (202308) Pacific Aviation Corporation : Anthem HSA Contributions,PAV,11555,,OBJ,,235.38,-29014.97
9/20/2023,9/20/2023,1028,11555 (202308) Pacific Aviation Corporation : Dental Vision and Ancilliary Benefits,PAV,11555,,OBJ,,13156.26,-42171.23
9/20/2023,9/20/2023,1030,11555 (202309) Pacific Aviation Corporation : Medical / Basic Life and AD&D,PAV,11555,,OBJ,,336928.46,-379099.69
9/20/2023,9/20/2023,1037,Kaiser Foundation Health Plan of WA /IN: 11555-202308-PREM1 11555 (202308) Pacific Aviation Corporation : Medical From Comp: CST,PAV,11555,,OBJ,912.94,,-378186.75
9/20/2023,9/20/2023,1038,Kaiser Foundation Health Plan of WA /IN: 11555-202309-PREM4 11555 (202309) Pacific Aviation Corporation : Medical From Comp: CST,PAV,11555,,OBJ,912.94,,-377273.81
9/20/2023,9/20/2023,1039,MetLife /IN: 11555-202308-PREM2 11555 (202308) Pacific Aviation Corporation : Dental Vision and Ancilliary Benefits From Comp: CST,PAV,11555,,OBJ,13156.26,,-364117.55
9/20/2023,9/20/2023,1040,Retirement 401K CST /IN: 11555-202308-PREM 11555 (202308) Pacific Aviation Corporation : Anthem HSA Contributions From Comp: CST,PAV,11555,,OBJ,235.38,,-363882.17
9/20/2023,9/20/2023,1041,Empire Health Choice Assurance /IN: 11555-202309-PREM3 11555 (202309) Pacific Aviation Corporation : Medical / Basic Life and AD&D From Comp: CST,PAV,11555,,OBJ,336928.46,,-26953.71
9/28/2023,9/28/2023,1059,Kaiser Foundation Health Plan of WA /IN: 11555-202310-PREM 11555 (202310) Pacific Aviation Corporation : Medical From Comp: CST,PAV,11555,,OBJ,1369.41,,-25584.3
9/29/2023,9/29/2023,1053,11555 (202306) Pacific Aviation : Bank Fee,PAV,11555,,OBJ,,250,-25834.3
9/29/2023,9/29/2023,1060,Boon Administrative Services /IN: 11555-202308-PREM 11555 (202308) Pacific Aviation : Boon Trust Fees From Comp: BGC,PAV,11555,,OBJ,14685,,-11149.3
9/29/2023,9/29/2023,1062,Boon Administrative Services /IN: 11555-202306-BANKFEE 11555 (202306) Pacific Aviation : Bank Fee From Comp: BGC,PAV,11555,,OBJ,,250,-11399.3
9/29/2023,9/29/2023,1064,Boon Administrative Services /IN: 11555-202306-BANKFEE 11555 (202306) Pacific Aviation : Bank Fee From Comp: BGC,PAV,11555,,OBJ,250,,-11149.3
9/29/2023,9/29/2023,1066,Boon Administrative Services /IN: 11555-202306-BANKFEE 11555 (202306) Pacific Aviation : Bank Fee From Comp: BGC,PAV,11555,,OBJ,250,,-10899.3
9/30/2023,9/30/2023,1085,11555 (202306) Pacific Aviation : Bank Fee,PAV,11555,,OBJ,,250,-11149.3
10/10/2023,10/10/2023,1113,Kaiser Foundation Health Plan of WA /IN: 11555-202310-PREM 11555 (202310) Pacific Aviation Corporation : Medical From Comp: CST,PAV,11555,,OBJ,456.47,,-10692.83
10/17/2023,10/17/2023,1118,Empire Health Choice Assurance /IN: 11555-202303-PREM 11555 (202303) Pacific Aviation Corporation : Medical/ Basic Life and AD&D From Comp: CST,PAV,11555,,OBJ,1491.79,,-9201.04
10/17/2023,10/17/2023,1119,Empire Health Choice Assurance /IN: 11555-202310-PREM1 11555 (202310) Pacific Aviation Corporation : Medical/ Basic Life and AD&D From Comp: CST,PAV,11555,,OBJ,246286.86,,237085.82
10/17/2023,10/17/2023,1126,11555 (202303) Pacific Aviation Corporation : Medical/ Basic Life and AD&D,PAV,11555,,OBJ,,1491.79,235594.03
10/17/2023,10/17/2023,1128,11555 (202310) Pacific Aviation Corporation : Medical/ Basic Life and AD&D,PAV,11555,,OBJ,,246286.86,-10692.83
10/24/2023,10/24/2023,1145,Kaiser Foundation Health Plan of WA /IN: 11555-202311-PREM 11555 (202311) Pacific Aviation Corporation : Medical From Comp: CST,PAV,11555,,OBJ,1369.41,,-9323.42
10/31/2023,10/31/2023,1158,11555 (202309-202310) Pacific Aviation Corporation : Anthem HSA Contributions,PAV,11555,,OBJ,,470.76,-9794.18
10/31/2023,10/31/2023,1165,Retirement 401K CST /IN: 11555-202310-PREM 11555 (202310) Pacific Aviation Corporation : Anthem HSA Contributions From Comp: CST,PAV,11555,,OBJ,470.76,,-9323.42
11/7/2023,11/7/2023,1174,"11555 (202309) Pacific Aviation : Dental, Vision and Acilliary Benefits",PAV,11555,,OBJ,,13243.79,-22567.21
11/7/2023,11/7/2023,1179,"MetLife /IN: 11555-202309-PREM 11555 (202309) Pacific Aviation : Dental, Vision and Acilliary Benefits From Comp: CST",PAV,11555,,OBJ,13243.79,,-9323.42
11/8/2023,11/8/2023,1180,"11555 (202310) Pacific Aviation : Dental, Vision and Ancilliary Benefits",PAV,11555,,OBJ,,14137.42,-23460.84
11/8/2023,11/8/2023,1185,"MetLife /IN: 11555-202310-PREM 11555 (202310) Pacific Aviation : Dental, Vision and Ancilliary Benefits From Comp: CST",PAV,11555,,OBJ,14137.42,,-9323.42
11/14/2023,11/14/2023,1198,11555 (202311) Pacific Aviation Corporation : Medical / Basic Life and AD&D,PAV,11555,,OBJ,,358688.63,-368012.05
11/14/2023,11/14/2023,1201,Empire Health Choice Assurance /IN: 11555-202311-PREM 11555 (202311) Pacific Aviation Corporation : Medical / Basic Life and AD&D From Comp: CST,PAV,11555,,OBJ,358688.63,,-9323.42
11/15/2023,11/15/2023,1208,Boon Administrative Services /IN: 11555-202306-BANKFEE 11555 (202306) Pacific Aviation : Bank Fee From Comp: BGC,PAV,11555,,OBJ,,250,-9573.42
11/15/2023,11/15/2023,1209,Boon Administrative Services /IN: 11555-202306-BNKFEE2 11555 (202306) Pacific Aviation : Bank Fee From Comp: BGC,PAV,11555,,OBJ,,250,-9823.42
11/15/2023,11/15/2023,1210,Boon Administrative Services /IN: 11555-202309-PREM 11555 (202309) Pacific Aviation : Boon Trust Fees From Comp: BGC,PAV,11555,,OBJ,16831,,7007.58
11/21/2023,11/21/2023,1220,"11555 (202311) Pacific Aviation : Dental, Vision, and Ancilliary Benefits",PAV,11555,,OBJ,,14137.42,-7129.84
11/21/2023,11/21/2023,1223,"MetLife /IN: 11555-202311-PREM 11555 (202311) Pacific Aviation : Dental, Vision, and Ancilliary Benefits From Comp: CST",PAV,11555,,OBJ,14137.42,,7007.58
11/21/2023,11/21/2023,1224,Boon Administrative Services /IN: 11555-202306-BANKFEE BGC INV: 11555-202306-BANKFEE From Comp: BGC,PAV,11555,,OBJ,250,,7257.58
11/21/2023,11/21/2023,1225,Boon Administrative Services /IN: 11555-202306-BNKFEE2 BGC INV: 11555-202306-BNKFEE2 From Comp: BGC,PAV,11555,,OBJ,250,,7507.58
11/29/2023,11/29/2023,1233,11189 (202310) CoreCivic : 10.25.23 HRA manual check paid from PAV,PAV,11555,,OBJ,,246.36,7261.22
11/29/2023,11/29/2023,1235,11189 (202310) CoreCivic : 10.31.23 HRA manual check paid from PAV,PAV,11555,,OBJ,,762.22,6499
12/5/2023,12/5/2023,,11555 Pacific Aviation Corp : HRA 120123 ; Check Register 120123,PAV,11555,,GJ,30,,6529
12/15/2023,12/15/2023,,11555 Pacific Aviation Corp; ACH: 12.13.2023 INCOMING ACH,PAV,11555,,GJ,,301374.18,-294845.18
12/18/2023,12/18/2023,,11555 (202312) Pacific Aviation Corporation : Anthem HSA Contributions,PAV,11555,,GJ,470.76,,-294374.42
12/18/2023,12/18/2023,,"11555 (202312) Pacific Aviation Corporation : Dental, Vision and Ancillary Benefits",PAV,11555,,GJ,11409.53,,-282964.89
12/18/2023,12/18/2023,,11555 (202312) Pacific Aviation Corporation : Medical / Basic Life and AD&D,PAV,11555,,GJ,271500.98,,-11463.91
12/26/2023,12/26/2023,,11555 Pacific Aviation Corp : HRA 121923 ; Check Register 121923,PAV,11555,,GJ,30.41,,-11433.5
12/28/2023,12/28/2023,,11555 (202310-202312) Pacific Aviation : Boon Trust Fees,PAV,11555,,GJ,47738,,36304.5
12/28/2023,12/28/2023,,11555 (202312) Pacific Aviation : Boon Trust Fees,PAV,11555,,GJ,47738,,84042.5
12/28/2023,12/28/2023,Reversed -,Reversed -- 11555 (202312) Pacific Aviation : Boon Trust Fees,PAV,11555,,GJ,,47738,36304.5
1/16/2024,1/16/2024,,11555 Pacific Aviation Corp; ACH: 01.12.2024 INCOMING ACH,PAV,11555,,GJ,,75917.1,-39612.6
1/26/2024,1/26/2024,,"11555 (202401) Pacific Aviation Corporation : Dental, Vision, Ancilliary Benefits",PAV,11555,,GJ,12207.26,,-27405.34
1/26/2024,1/26/2024,,11555 (202401) Pacific Aviation Corporation : Medical / Basic Life and AD&D,PAV,11555,,GJ,226078.75,,198673.41
1/31/2024,1/31/2024,,11555 (202401) Pacific Aviation : Anthem Life,PAV,11555,,GJ,3244.5,,201917.91
2/6/2024,2/6/2024,,11555 (202401) Pacific Aviation Corporation : Medical / Basic Life and AD&D,PAV,11555,,GJ,277621.4,,479539.31
2/6/2024,2/6/2024,,11555 (202401) Pacific Aviation Corporation : Medical / Basic Life and AD&D,PAV,11555,,AE,,277621.4,201917.91
2/14/2024,2/14/2024,,11555 (202303) Pacific Aviation : Medical / Basic Life and AD&D,PAV,11555,,GJ,260923.41,,462841.32
2/14/2024,2/14/2024,,11555 (202312) Pacific Aviation : Anthem Life / Compassi,PAV,11555,,GJ,2003.8,,464845.12
2/14/2024,2/14/2024,,"11555 (202402 Pacific Aviation : Dental, Vision and Ancillary Benefits",PAV,11555,,GJ,12673.05,,477518.17
2/14/2024,2/14/2024,,11555 (202402) Pacific Aviation : Anthem HSA Contributions,PAV,11555,,GJ,470.76,,477988.93
2/14/2024,2/14/2024,,11555 (202403) Pacific Aviation : Medical / Basic Life and AD&D,PAV,11555,,AE,,260923.41,217065.52
2/14/2024,2/14/2024,,11555 (202401-202402) Pacific Aviation : Anthem HSA Contributions,PAV,11555,,AE,,470.76,216594.76
2/14/2024,2/14/2024,,"11555 (202402 Pacific Aviation : Dental, Vision and Ancillary Benefits",PAV,11555,,AE,,12673.05,203921.71
2/16/2024,2/16/2024,,11555 (202402) Pacific Aviation : Boon Trust Fees,PAV,11555,,GJ,31284,,235205.71
2/21/2024,2/21/2024,,11555 Pacific Aviation Corp : HRA 021224 ; Check Register 021224,PAV,11555,,GJ,8.62,,235214.33
2/27/2024,2/27/2024,,"11555 (202402) Pacific Aviation : Dental, Vision, and Ancillary Benefits",PAV,11555,,GJ,74.66,,235288.99
2/27/2024,2/27/2024,,"11555 (202402) Pacific Aviation : Dental, Vision, and Ancillary Benefits",PAV,11555,,AE,,74.66,235214.33
3/18/2024,3/18/2024,,"11555 (202402) Pacific Aviation : Dental, Vision and Ancillary Benefits",PAV,11555,,GJ,12047.35,,247261.68
3/18/2024,3/18/2024,,11555 (202403) Pacific Aviation : Anthem HAS Contributions,PAV,11555,,GJ,235.38,,247497.06
3/18/2024,3/18/2024,,11555 (202404) Pacific Aviation : Medical / Basic Life and AD&D,PAV,11555,,GJ,289443.11,,536940.17
3/18/2024,3/18/2024,,"11555 (202402) Pacific Aviation : Dental, Vision and Ancillary Benefits",PAV,11555,,AE,,12047.35,524892.82
3/18/2024,3/18/2024,,11555 (202403) Pacific Aviation : Anthem HAS Contributions,PAV,11555,,AE,,235.38,524657.44
3/18/2024,3/18/2024,,11555 (202404) Pacific Aviation : Medical / Basic Life and AD&D,PAV,11555,,AE,,289443.11,235214.33
3/25/2024,3/25/2024,,11555 (202403) Pacific Aviation : Boon Trust Fees,PAV,11555,,GJ,14917,,250131.33
4/19/2024,4/19/2024,,11555 (202404) Pacific Aviation Corporation : Anthem HSA Contributions,PAV,11555,,GJ,235.38,,250366.71
4/19/2024,4/19/2024,,11555 (202404) Pacific Aviation Corporation : Anthem Life/Compassi,PAV,11555,,GJ,1746.18,,252112.89
4/19/2024,4/19/2024,,"11555 (202404) Pacific Aviation Corporation : Dental, Vision, and Ancillary Benefits",PAV,11555,,GJ,12447.53,,264560.42
4/19/2024,4/19/2024,,11555 (202404) Pacific Aviation Corporation : Anthem HSA Contributions,PAV,11555,,AE,,235.38,264325.04
4/19/2024,4/19/2024,,"11555 (202404) Pacific Aviation Corporation : Dental, Vision, and Ancillary Benefits",PAV,11555,,AE,,12447.53,251877.51
4/25/2024,4/25/2024,,11555 (202404) Pacific Aviation : Boon Trust Fees,PAV,11555,,GJ,17759,,269636.51
5/23/2024,5/23/2024,,11555 (202405) Pacific Aviation : Anthem Life/Compassi,PAV,11555,,GJ,1798.68,,271435.19
5/23/2024,5/23/2024,,"11555 (202405) Pacific Aviation : Dental, Vision, and Ancillary Benefits",PAV,11555,,GJ,11836.62,,283271.81
5/23/2024,5/23/2024,,11555 (202405) Pacific Aviation Corporation : Anthem HSA Contributions,PAV,11555,,GJ,235.38,,283507.19
5/23/2024,5/23/2024,,11555 (202405) Pacific Aviation Corporation : Medical/ Basic Life and AD&D,PAV,11555,,GJ,260938.96,,544446.15
5/23/2024,5/23/2024,,"11555 (202405) Pacific Aviation : Dental, Vision, and Ancillary Benefits",PAV,11555,,AE,,11836.62,532609.53
5/23/2024,5/23/2024,,11555 (202405) Pacific Aviation Corporation : Anthem HSA Contributions,PAV,11555,,AE,,235.38,532374.15
5/23/2024,5/23/2024,,11555 (202405) Pacific Aviation Corporation : Medical/ Basic Life and AD&D,PAV,11555,,AE,,260938.96,271435.19
5/28/2024,5/28/2024,,11555 (202405) Pacific Aviation : Boon Trust Fees,PAV,11555,,GJ,16251,,287686.19
6/3/2024,6/3/2024,,11555 Pacific Aviation : Evolution Benefits ; 05/27/24 - 06/02/24,PAV,11555,,GJ,4286.37,,291972.56
6/10/2024,6/10/2024,,11555 Pacific Aviation : Evolution Benefits ; 06/03/24 - 06/09/24,PAV,11555,,GJ,741.57,,292714.13
 Totals for 210000 - General Accounts Payable,,,,,,,,3406737.45,3089776.12,292714.13
320000 - Retained Earnings (Balance forward As of 07/01/2023) ,,,,,,,,,,0
7/1/2023,7/1/2023,,Retained Earnings Adjustments --Original GL Account:410000-11555,PAV,11555,,OBJ,3015786.76,,3015786.76
7/1/2023,7/1/2023,,Retained Earnings Adjustments --Original GL Account:412000-11555,PAV,11555,,OBJ,1521.64,,3017308.4
7/1/2023,7/1/2023,,Retained Earnings Adjustments --Original GL Account:490000-11555,PAV,11555,,OBJ,8032.24,,3025340.64
7/1/2023,7/1/2023,,Retained Earnings Adjustments --Original GL Account:621000-11555,PAV,11555,,OBJ,,2169506.06,855834.58
7/1/2023,7/1/2023,,Retained Earnings Adjustments --Original GL Account:621010-11555,PAV,11555,,OBJ,,116838.03,738996.55
7/1/2023,7/1/2023,,Retained Earnings Adjustments --Original GL Account:661000-11555,PAV,11555,,OBJ,,20549.01,718447.54
7/1/2023,7/1/2023,,Retained Earnings Adjustments --Original GL Account:662000-11555,PAV,11555,,OBJ,,2160,716287.54
7/1/2023,7/1/2023,,Retained Earnings Adjustments --Original GL Account:762000-11555,PAV,11555,,OBJ,,29.84,716257.7
7/1/2023,7/1/2023,,Retained Earnings Adjustments --Original GL Account:764000-11555,PAV,11555,,OBJ,,143014.13,573243.57
7/1/2023,7/1/2023,,Retained Earnings Adjustments --Original GL Account:830000-11555,PAV,11555,,OBJ,,2000,571243.57
7/1/2023,7/1/2023,,Retained Earnings Balancing Entry --Original GL Account:320000-00000,PAV,0,,OBJ,,571243.57,0
7/31/2023,7/31/2023,,11555 (202307) Pacific Aviation : Asset Balance - Interest,PAV,11555,,AE,2154.03,,2154.03
7/31/2023,7/31/2023,,11555 (202307) Pacific Aviation : HRA Reserve,PAV,11555,,AE,111726.51,,113880.54
7/31/2023,7/31/2023,,11555 (202307) Pacific Aviation : RE,PAV,11555,,AE,,52226.14,61654.4
8/31/2023,8/31/2023,,11555 (202308) Pacific Aviation : Asset Balance - Interest,PAV,11555,,AE,3167.31,,64821.71
8/31/2023,8/31/2023,,11555 (202308) Pacific Aviation : HRA Reserve,PAV,11555,,AE,31375.89,,96197.6
8/31/2023,8/31/2023,,11555 (202308) Pacific Aviation : RE,PAV,11555,,AE,,35843.46,60354.14
 Totals for 320000 - Retained Earnings,,,,,,,,3173764.38,3113410.24,60354.14
351000 - HRA Reserve (Balance forward As of 07/01/2023) ,,,,,,,,,,-559453.05
7/31/2023,7/31/2023,,11555 (202307) Pacific Aviation : HRA Reserve,PAV,11555,,AE,,111726.51,-671179.56
8/31/2023,8/31/2023,,11555 (202308) Pacific Aviation : HRA Reserve,PAV,11555,,AE,,31375.89,-702555.45
 Totals for 351000 - HRA Reserve,,,,,,,,0,143102.4,-702555.45
371000 - Asset Balance (Balance forward As of 07/01/2023) ,,,,,,,,,,-11790.52
7/31/2023,7/31/2023,,11555 (202307) Pacific Aviation : Asset Balance - Interest,PAV,11555,,AE,,2154.03,-13944.55
8/31/2023,8/31/2023,,11555 (202308) Pacific Aviation : Asset Balance - Interest,PAV,11555,,AE,,3167.31,-17111.86
 Totals for 371000 - Asset Balance,,,,,,,,0,5321.34,-17111.86
410000 - Contributions (Balance forward As of 07/01/2023) ,,,,,,,,,,0
7/31/2023,7/31/2023,,11555 (202307) Pacific Aviation : Contributions,PAV,11555,,AE,,301115.13,-301115.13
8/31/2023,8/31/2023,,11555 (202308) Pacific Aviation : Contributions,PAV,11555,,AE,,265262.05,-566377.18
 Totals for 410000 - Contributions,,,,,,,,0,566377.18,-566377.18
490000 - Interest Income (Balance forward As of 07/01/2023) ,,,,,,,,,,0
7/31/2023,7/31/2023,855,Chk: CD000017 07/31/23 11555 (202307) Pacific Aviation : Cash Mgmt Sweep Fee,PAV,11555,,OBJ,285.42,,285.42
7/31/2023,7/31/2023,859,Doc: CR000015 07/31/23 11555 (202307) Pacific Aviation : Interest Revenue,PAV,11555,,OBJ,,2439.45,-2154.03
8/31/2023,8/31/2023,988,Chk: CD000020 08/31/23 11555 (202308) Pacific Aviation : Cash Mgmt Sweep Fee,PAV,11555,,OBJ,230.01,,-1924.02
8/31/2023,8/31/2023,990,Doc: CR000016 08/31/23 11555 (202308) Pacific Aviation : Interest Revenue,PAV,11555,,OBJ,,3397.32,-5321.34
9/30/2023,9/30/2023,1078,Chk: CD00021 09/30/23 11555 (202309) Pacific Aviation : Cash Mgmt Sweep Fee,PAV,11555,,OBJ,309.38,,-5011.96
9/30/2023,9/30/2023,1082,Doc: CR00017 09/30/23 11555 (202309) Pacific Aviation : Interest Revenue,PAV,11555,,OBJ,,3025.57,-8037.53
10/31/2023,10/31/2023,1186,Chk: CD000023 10/31/23 11555 (202310) Pacific Aviation : Cash Mgmt Sweep Fee,PAV,11555,,OBJ,284.55,,-7752.98
10/31/2023,10/31/2023,1190,Doc: CR000018 10/31/23 11555 (202310) Pacific Aviation : Interest Revenue,PAV,11555,,OBJ,,4189.48,-11942.46
11/30/2023,11/30/2023,1254,Chk: CD000025 11/30/23 11555 (202311) Pacific Aviation : Cash Mgmt Sweep Fee,PAV,11555,,OBJ,380.43,,-11562.03
11/30/2023,11/30/2023,1258,Doc: CR000019 11/30/23 11555 (202311) Pacific Aviation : Interest,PAV,11555,,OBJ,,4711.61,-16273.64
12/31/2023,12/31/2023,,Bank Interest Earned: Interest earned,PAV,11555,,CDJ,,5053.02,-21326.66
12/31/2023,12/31/2023,,Bank Service Charge: Service charge,PAV,11555,,CDJ,439.71,,-20886.95
1/31/2024,1/31/2024,,Reclass 202312 Cash Mgmt Fee from Bank Fees to Interest Income,PAV,0,,AE,455.88,,-20431.07
1/31/2024,1/31/2024,,Bank Interest Earned: 11155 (202401) Pacific Aviation : Interest Revenue,PAV,0,,CDJ,,4763.02,-25194.09
1/31/2024,1/31/2024,,Bank Interest Earned: 11155 (202401) Pacific Aviation : Interest Revenue,PAV,0,,CDJ,,0,-25194.09
2/9/2024,2/9/2024,,Bank Interest Earned: 11555 (202401) Pacific Aviation : Bank Fees,PAV,0,,CDJ,,4763.02,-29957.11
2/9/2024,2/9/2024,,Bank Interest Earned: 11555 (202401) Pacific Aviation : Bank Fees,PAV,0,,CDJ,4763.02,,-25194.09
2/29/2024,2/29/2024,,Bank Interest Earned: 11555 Pacific Aviation Corp : Interest Revenue,PAV,,,CDJ,,3924.37,-29118.46
2/29/2024,2/29/2024,,Bank Service Charge: 11555 Pacific Aviation Corp : Cash Management Sweep Fee,PAV,,,CDJ,431.11,,-28687.35
3/31/2024,3/31/2024,,Bank Interest Earned: 11555 (202403) Pacific Aviation Corp : Interest Revenue,PAV,,,CDJ,,4368.29,-33055.64
3/31/2024,3/31/2024,,Bank Service Charge: 11555 (202403) Pacific Aviation Corp : Cash Management Sweep Fee,PAV,,,CDJ,381.39,,-32674.25
4/30/2024,4/30/2024,,Bank Interest Earned: 11555 (202404) Pacific Aviation Corp : Interest Revenue,PAV,,,CDJ,,4778.03,-37452.28
4/30/2024,4/30/2024,,Bank Service Charge: 11555 (202404) Pacific Aviation Corp : Cash Management Sweep Fee,PAV,11555,,CDJ,398.67,,-37053.61
5/31/2024,5/31/2024,,Bank Interest Earned: 11555 (202405) Pacific Aviation Corp : Interest Revenue,PAV,,,CDJ,,5858.59,-42912.2
5/31/2024,5/31/2024,,Bank Service Charge: 11555 (202405) Pacific Aviation Corp : Cash Management Sweep Fee,PAV,11555,,CDJ,451.6,,-42460.6
 Totals for 490000 - Interest Income,,,,,,,,8811.17,51271.77,-42460.6
621000 - Outside Vendor Premium Expense (Balance forward As of 07/01/2023) ,,,,,,,,,,0
7/12/2023,7/12/2023,808,11555 (202307) Pacific Aviation Corporation : Medical/Basic Life and AD&D,PAV,11555,,OBJ,204615.69,,204615.69
7/31/2023,7/31/2023,,11555 (202307) Pacific Aviation : Kaiser Medical,PAV,11555,,AE,912.94,,205528.63
8/30/2023,8/30/2023,977,11555 (202308) Pacific Aviation Corporation : Medical / Basic Life and AD&D,PAV,11555,,OBJ,235992.47,,441521.1
8/31/2023,8/31/2023,,11555 (202308) Pacific Aviation : Kaiser Medical,PAV,11555,,AE,912.94,,442434.04
9/20/2023,9/20/2023,1031,11555 (202309) Pacific Aviation Corporation : Medical / Basic Life and AD&D,PAV,11555,,OBJ,336928.46,,779362.5
10/17/2023,10/17/2023,1127,11555 (202303) Pacific Aviation Corporation : Medical/ Basic Life and AD&D,PAV,11555,,OBJ,1491.79,,780854.29
10/17/2023,10/17/2023,1129,11555 (202310) Pacific Aviation Corporation : Medical/ Basic Life and AD&D,PAV,11555,,OBJ,246286.86,,1027141.15
11/14/2023,11/14/2023,1199,11555 (202311) Pacific Aviation Corporation : Medical / Basic Life and AD&D,PAV,11555,,OBJ,358688.63,,1385829.78
2/6/2024,2/6/2024,,11555 (202401) Pacific Aviation Corporation : Medical / Basic Life and AD&D,PAV,11555,,AE,277621.4,,1663451.18
2/14/2024,2/14/2024,,11555 (202403) Pacific Aviation : Medical / Basic Life and AD&D,PAV,11555,,AE,260923.41,,1924374.59
3/18/2024,3/18/2024,,11555 (202404) Pacific Aviation : Medical / Basic Life and AD&D,PAV,11555,,AE,289443.11,,2213817.7
5/23/2024,5/23/2024,,11555 (202405) Pacific Aviation Corporation : Medical/ Basic Life and AD&D,PAV,11555,,AE,260938.96,,2474756.66
 Totals for 621000 - Outside Vendor Premium Expense,,,,,,,,2474756.66,0,2474756.66
621010 - Medical Premium Expense (Balance forward As of 07/01/2023) ,,,,,,,,,,0
7/31/2023,7/31/2023,,11555 (202307) Pacific Aviation : MetLife Dental & Vision,PAV,11555,,AE,7044.62,,7044.62
7/31/2023,7/31/2023,,"11555 (202307) Pacific Aviation : MetLife Life, CI, Acc, Hosp",PAV,11555,,AE,5047.25,,12091.87
7/31/2023,7/31/2023,,11555 (202307) Pacific Aviation : MetLife STD & LTD,PAV,11555,,AE,1458.56,,13550.43
8/2/2023,8/2/2023,842,"11555 (202306) Pacific Aviation : Dental, Vision, Ancillary",PAV,11555,,OBJ,10171.33,,23721.76
8/30/2023,8/30/2023,975,"11555 (202307) Pacific Aviation Corporation : Dental, Vision, and Ancillary Benefits",PAV,11555,,OBJ,13550.43,,37272.19
8/31/2023,8/31/2023,,11555 (202306) Pacific Aviation : MetLife Dental & Vision,PAV,11555,,AE,,5310.59,31961.6
8/31/2023,8/31/2023,,"11555 (202306) Pacific Aviation : MetLife Life, CI, Acc, Hosp",PAV,11555,,AE,,3682.75,28278.85
8/31/2023,8/31/2023,,11555 (202306) Pacific Aviation : MetLife STD & LTD,PAV,11555,,AE,,1178,27100.85
8/31/2023,8/31/2023,,11555 (202307) Pacific Aviation : MetLife Dental & Vision,PAV,11555,,AE,,7044.62,20056.23
8/31/2023,8/31/2023,,"11555 (202307) Pacific Aviation : MetLife Life, CI, Acc, Hosp",PAV,11555,,AE,,5047.25,15008.98
8/31/2023,8/31/2023,,11555 (202307) Pacific Aviation : MetLife STD & LTD,PAV,11555,,AE,,1458.56,13550.42
8/31/2023,8/31/2023,,11555 (202308) Pacific Aviation : MetLife Dental & Vision,PAV,11555,,AE,6852.39,,20402.81
8/31/2023,8/31/2023,,"11555 (202308) Pacific Aviation : MetLife Life, CI, Acc, Hosp",PAV,11555,,AE,4858.08,,25260.89
8/31/2023,8/31/2023,,11555 (202308) Pacific Aviation : MetLife STD & LTD,PAV,11555,,AE,1445.8,,26706.69
9/20/2023,9/20/2023,1029,11555 (202308) Pacific Aviation Corporation : Dental Vision and Ancilliary Benefits,PAV,11555,,OBJ,13156.26,,39862.95
11/7/2023,11/7/2023,1175,"11555 (202309) Pacific Aviation : Dental, Vision and Acilliary Benefits",PAV,11555,,OBJ,13243.79,,53106.74
11/8/2023,11/8/2023,1181,"11555 (202310) Pacific Aviation : Dental, Vision and Ancilliary Benefits",PAV,11555,,OBJ,14137.42,,67244.16
11/21/2023,11/21/2023,1221,"11555 (202311) Pacific Aviation : Dental, Vision, and Ancilliary Benefits",PAV,11555,,OBJ,14137.42,,81381.58
2/14/2024,2/14/2024,,"11555 (202402 Pacific Aviation : Dental, Vision and Ancillary Benefits",PAV,11555,,AE,12673.05,,94054.63
2/27/2024,2/27/2024,,"11555 (202402) Pacific Aviation : Dental, Vision, and Ancillary Benefits",PAV,11555,,AE,74.66,,94129.29
3/18/2024,3/18/2024,,"11555 (202402) Pacific Aviation : Dental, Vision and Ancillary Benefits",PAV,11555,,AE,12047.35,,106176.64
4/19/2024,4/19/2024,,"11555 (202404) Pacific Aviation Corporation : Dental, Vision, and Ancillary Benefits",PAV,11555,,AE,12447.53,,118624.17
5/23/2024,5/23/2024,,"11555 (202405) Pacific Aviation : Dental, Vision, and Ancillary Benefits",PAV,11555,,AE,11836.62,,130460.79
 Totals for 621010 - Medical Premium Expense,,,,,,,,154182.56,23721.77,130460.79
661000 - HRA Expense (Balance forward As of 07/01/2023) ,,,,,,,,,,0
7/3/2023,7/3/2023,784,Evolution Benefits /IN: 11555-070223-HRA 11555 Pacific Aviation : Evolution Benefits ; 06/26/23 - 07/02/23 From Comp: BGC,PAV,11555,,OBJ,2292.84,,2292.84
7/10/2023,7/10/2023,800,Evolution Benefits /IN: 11555-070923-HRA 11555 Pacific Aviation : Evolution Benefits ; 07/03/23 - 07/09/23 From Comp: BGC,PAV,11555,,OBJ,366.19,,2659.03
7/19/2023,7/19/2023,824,Evolution Benefits /IN: 11555-071623-HRA 11555 Pacific Aviation : Evolution Benefits ; 07/10/23 - 07/16/23 From Comp: BGC,PAV,11555,,OBJ,1938.14,,4597.17
7/24/2023,7/24/2023,828,Evolution Benefits /IN: 11555-072323-HRA 11555 Pacific Aviation : Evolution Benefits ; 07/17/23 - 07/23/23 From Comp: BGC,PAV,11555,,OBJ,990.18,,5587.35
7/31/2023,7/31/2023,836,Evolution Benefits /IN: 11555-073023-HRA 11555 Pacific Aviation : Evolution Benefits ; 07/24/23 - 07/30/23 From Comp: BGC,PAV,11555,,OBJ,1011.97,,6599.32
7/31/2023,7/31/2023,,11555 (202307) Pacific Aviation : HRA Debit Card Fee,PAV,11555,,AE,40,,6639.32
8/7/2023,8/7/2023,850,Evolution Benefits /IN: 11555-080623-HRA 11555 Pacific Aviation : Evolution Benefits ; 07/31/23 - 08/06/23 From Comp: BGC,PAV,11555,,OBJ,1388.26,,8027.58
8/8/2023,8/8/2023,853,11555 Pacific Aviation Corp : HRA 080123 ; Check Register 080123,PAV,11555,,OBJ,200,,8227.58
8/14/2023,8/14/2023,864,Evolution Benefits /IN: 11555-081323-HRA 11555 Pacific Aviation : Evolution Benefits ; 08/07/23 - 08/13/23 From Comp: BGC,PAV,11555,,OBJ,1281.15,,9508.73
8/21/2023,8/21/2023,945,Evolution Benefits /IN: 11555-082023-HRA 11555 Pacific Aviation : Evolution Benefits ; 08/14/23 - 08/20/23 From Comp: BGC,PAV,11555,,OBJ,1308.16,,10816.89
8/28/2023,8/28/2023,955,Evolution Benefits /IN: 11555-082023-HRA 11555 Pacific Aviation : Evolution Benefits ; 08/21/23 - 08/27/23 From Comp: BGC,PAV,11555,,OBJ,319.97,,11136.86
9/5/2023,9/5/2023,985,Evolution Benefits /IN: 11555-090323-HRA 11555 Pacific Aviation : Evolution Benefits ; 08/28/23 - 09/03/23 From Comp: BGC,PAV,11555,,OBJ,2199.06,,13335.92
9/11/2023,9/11/2023,1005,Evolution Benefits /IN: 11555-091023-HRA 11555 Pacific Aviation : Evolution Benefits ; 09/04/23 - 09/10/23 From Comp: BGC,PAV,11555,,OBJ,1761.79,,15097.71
9/18/2023,9/18/2023,1013,Evolution Benefits /IN: 11555-091723-HRA 11555 Pacific Aviation : Evolution Benefits ; 09/11/23 - 09/17/23 From Comp: BGC,PAV,11555,,OBJ,1476.19,,16573.9
9/25/2023,9/25/2023,1049,Evolution Benefits /IN: 11555-092423-HRA 11555 Pacific Aviation : Evolution Benefits ; 09/18/23 - 09/24/23 From Comp: BGC,PAV,11555,,OBJ,4497.61,,21071.51
10/2/2023,10/2/2023,1069,Evolution Benefits /IN: 11555-100123-HRA 11555 Pacific Aviation : Evolution Benefits ; 09/25/23 - 10/01/23 From Comp: BGC,PAV,11555,,OBJ,1981.8,,23053.31
10/4/2023,10/4/2023,1071,11555 Pacific Aviation : HRA 100223 ; Check Register 100223,PAV,11555,,OBJ,,400,22653.31
10/10/2023,10/10/2023,1102,11555 Pacific Aviation : HRA 100223 ; Check Register 100223,PAV,11555,,OBJ,600,,23253.31
10/10/2023,10/10/2023,1111,Evolution Benefits /IN: 11555-100823-HRA 11555 Pacific Aviation : Evolution Benefits ; 10/02/23 - 10/08/23 From Comp: BGC,PAV,11555,,OBJ,1171.6,,24424.91
10/16/2023,10/16/2023,1115,Evolution Benefits /IN: 11555-101523-HRA 11555 Pacific Aviation : Evolution Benefits ; 10/09/23 - 10/15/23 From Comp: BGC,PAV,11555,,OBJ,969.76,,25394.67
10/17/2023,10/17/2023,1122,11555 Pacific Aviation : HRA 101123 ; Check Register 101123,PAV,11555,,OBJ,228.78,,25623.45
10/24/2023,10/24/2023,1143,Evolution Benefits /IN: 11555-102223-HRA 11555 Pacific Aviation : Evolution Benefits ; 10/16/23 - 10/22/23 From Comp: BGC,PAV,11555,,OBJ,2391.34,,28014.79
10/25/2023,10/25/2023,1146,11555 Pacific Aviation : HRA 101823 ; Check Register 101823,PAV,11555,,OBJ,246.36,,28261.15
10/30/2023,10/30/2023,1163,Evolution Benefits /IN: 11555-102923-HRA 11555 Pacific Aviation : Evolution Benefits ; 10/23/23 - 10/29/23 From Comp: BGC,PAV,11555,,OBJ,1108.29,,29369.44
10/31/2023,10/31/2023,1152,11555 Pacific Aviation : HRA 102523 ; Check Register 102523,PAV,11555,,OBJ,762.22,,30131.66
11/6/2023,11/6/2023,1173,Evolution Benefits /IN: 11555-110523-HRA 11555 Pacific Aviation : Evolution Benefits ; 10/30/23 - 11/05/23 From Comp: BGC,PAV,11555,,OBJ,3344.12,,33475.78
11/13/2023,11/13/2023,1193,Evolution Benefits /IN: 11555-111223-HRA 11555 Pacific Aviation : Evolution Benefits ; 11/06/23 - 11/12/23 From Comp: BGC,PAV,11555,,OBJ,3256.47,,36732.25
11/20/2023,11/20/2023,1217,Evolution Benefits /IN: 11555-111923-HRA 11555 Pacific Aviation : Evolution Benefits ; 11/13/23 - 11/19/23 From Comp: BGC,PAV,11555,,OBJ,4124.49,,40856.74
11/27/2023,11/27/2023,1231,Evolution Benefits /IN: 11555-112623-HRA 11555 Pacific Aviation : Evolution Benefits ; 11/20/23 - 11/26/23 From Comp: BGC,PAV,11555,,OBJ,4985.92,,45842.66
12/4/2023,12/4/2023,,11555 Pacific Aviation : Evolution Benefits ; 11/27/23 - 12/03/23,PAV,11555,,GJ,1961.05,,47803.71
12/11/2023,12/11/2023,,11555 Pacific Aviation : Evolution Benefits ; 12/04/23 - 12/10/23,PAV,11555,,GJ,2474.91,,50278.62
12/18/2023,12/18/2023,,11555 Pacific Aviation : Evolution Benefits ; 12/11/23 - 12/17/23,PAV,11555,,GJ,3285.65,,53564.27
12/26/2023,12/26/2023,,11555 Pacific Aviation : Evolution Benefits ; 12/18/23 - 12/24/23,PAV,11555,,GJ,1814.91,,55379.18
1/2/2024,1/2/2024,,11555 Pacific Aviation : Evolution Benefits ; 12/25/23 - 01/01/24,PAV,11555,,GJ,2053.37,,57432.55
1/8/2024,1/8/2024,,11555 Pacific Aviation : Evolution Benefits ; 01/01/24 - 01/07/24,PAV,11555,,GJ,2568.97,,60001.52
1/16/2024,1/16/2024,,11555 Pacific Aviation : Evolution Benefits ; 01/08/24 - 01/14/24,PAV,11555,,GJ,2247.93,,62249.45
1/22/2024,1/22/2024,,11555 Pacific Aviation : Evolution Benefits ; 01/15/23 - 01/21/23,PAV,11555,,GJ,2648.22,,64897.67
1/29/2024,1/29/2024,,11555 Pacific Aviation : Evolution Benefits ; 01/22/24 - 01/28/24,PAV,11555,,GJ,2981.13,,67878.8
2/5/2024,2/5/2024,,11555 Pacific Aviation : Evolution Benefits ; 01/29/24 - 02/04/24,PAV,11555,,GJ,4990.84,,72869.64
2/12/2024,2/12/2024,,11555 Pacific Aviation : Evolution Benefits ; 02/05/24 - 02/11/24,PAV,11555,,GJ,3265.04,,76134.68
2/20/2024,2/20/2024,,11555 Pacific Aviation : Evolution Benefits ; 02/12/24 - 02/18/24,PAV,11555,,GJ,4857.24,,80991.92
2/26/2024,2/26/2024,,11555 Pacific Aviation : Evolution Benefits ; 02/19/24 - 02/25/24,PAV,11555,,GJ,3233.65,,84225.57
3/4/2024,3/4/2024,,11555 Pacific Aviation : Evolution Benefits ; 02/26/24- 03/03/24,PAV,11555,,GJ,1387.18,,85612.75
3/11/2024,3/11/2024,,11555 Pacific Aviation : Evolution Benefits ; 03/04/24 - 03/10/24,PAV,11555,,GJ,3645.2,,89257.95
3/18/2024,3/18/2024,,11555 Pacific Aviation : Evolution Benefits ; 03/11/24 - 03/17/24,PAV,11555,,GJ,4119.25,,93377.2
3/25/2024,3/25/2024,,11555 Pacific Aviation : Evolution Benefits ; 03/18/24 - 03/24/24,PAV,11555,,GJ,3101.64,,96478.84
4/1/2024,4/1/2024,,11555 Pacific Aviation : Evolution Benefits ; 03/25/24 - 03/31/24,PAV,11555,,GJ,1341.39,,97820.23
4/8/2024,4/8/2024,,11555 Pacific Aviation : Evolution Benefits ; 04/01/24 - 04/07/24,PAV,11555,,GJ,3835.62,,101655.85
4/9/2024,4/9/2024,,11555 Pacific Aviation Corp : HRA 040224 ; Check Register 040224,PAV,11555,,GJ,22.2,,101678.05
4/15/2024,4/15/2024,,11555 Pacific Aviation : Evolution Benefits ; 04/08/24 - 04/14/24,PAV,11555,,GJ,4325.37,,106003.42
4/22/2024,4/22/2024,,11555 Pacific Aviation : Evolution Benefits ; 04/15/24 - 04/21/24,PAV,11555,,GJ,2694.73,,108698.15
4/29/2024,4/29/2024,,11555 Pacific Aviation : Evolution Benefits ; 04/22/24/ - 04/28/24,PAV,11555,,GJ,3488.27,,112186.42
5/6/2024,5/6/2024,,11555 Pacific Aviation : Evolution Benefits ; 04/29/24 - 05/05/24,PAV,11555,,GJ,2860.26,,115046.68
5/13/2024,5/13/2024,,11555 Pacific Aviation : Evolution Benefits ; 05/06/24 - 05/12/24,PAV,11555,,GJ,1008.61,,116055.29
5/20/2024,5/20/2024,,11555 Pacific Aviation : Evolution Benefits ; 05/13/24 - 05/19/24,PAV,11555,,GJ,3946.7,,120001.99
5/21/2024,5/21/2024,,11555 Pacific Aviation Corp : HRA 051624 ; Check Register 051624,PAV,11555,,GJ,25.42,,120027.41
5/28/2024,5/28/2024,,11555 Pacific Aviation : Evolution Benefits ; 05/20/24 - 05/27/24,PAV,11555,,GJ,3823.08,,123850.49
 Totals for 661000 - HRA Expense,,,,,,,,124250.49,400,123850.49
662000 - Health Savings Account (Balance forward As of 07/01/2023) ,,,,,,,,,,0
7/31/2023,7/31/2023,,11555 (202307) Pacific Aviation : HSA Fee,PAV,11555,,AE,265.38,,265.38
8/30/2023,8/30/2023,973,11555 (202307) Pacific Aviation Corporation : Anthem HSA Contributions,PAV,11555,,OBJ,265.38,,530.76
8/31/2023,8/31/2023,,11555 (202307) Pacific Aviation : HSA Fee,PAV,11555,,AE,,265.38,265.38
8/31/2023,8/31/2023,,11555 (202308) Pacific Aviation : HSA Fee,PAV,11555,,AE,235.38,,500.76
9/20/2023,9/20/2023,1027,11555 (202308) Pacific Aviation Corporation : Anthem HSA Contributions,PAV,11555,,OBJ,235.38,,736.14
10/31/2023,10/31/2023,1159,11555 (202309-202310) Pacific Aviation Corporation : Anthem HSA Contributions,PAV,11555,,OBJ,470.76,,1206.9
2/14/2024,2/14/2024,,11555 (202401-202402) Pacific Aviation : Anthem HSA Contributions,PAV,11555,,AE,470.76,,1677.66
3/18/2024,3/18/2024,,11555 (202403) Pacific Aviation : Anthem HAS Contributions,PAV,11555,,AE,235.38,,1913.04
4/19/2024,4/19/2024,,11555 (202404) Pacific Aviation Corporation : Anthem HSA Contributions,PAV,11555,,AE,235.38,,2148.42
5/23/2024,5/23/2024,,11555 (202405) Pacific Aviation Corporation : Anthem HSA Contributions,PAV,11555,,AE,235.38,,2383.8
 Totals for 662000 - Health Savings Account,,,,,,,,2649.18,265.38,2383.8
764000 - Trust Fees (Balance forward As of 07/01/2023) ,,,,,,,,,,0
7/31/2023,7/31/2023,,11555 (202307) Pacific Aviation : Trust Fees,PAV,11555,,AE,15381,,15381
8/31/2023,8/31/2023,,11555 (202308) Pacific Aviation : Trust Fees,PAV,11555,,AE,14685,,30066
 Totals for 764000 - Trust Fees,,,,,,,,30066,0,30066
830000 - Bank Fees (Balance forward As of 07/01/2023) ,,,,,,,,,,0
7/31/2023,7/31/2023,857,Chk: CD000018 07/31/23 11555 (202307) Pacific Aviation : Bank Fee --,PAV,11555,,OBJ,250,,250
8/31/2023,8/31/2023,986,Chk: CD000019 08/31/23 11555 (202308) Pacific Aviation : Bank Fee,PAV,11555,,OBJ,250,,500
9/30/2023,9/30/2023,1080,Chk: CD00022 09/30/23 11555 (202309) Pacific Aviation : Bank Fee,PAV,11555,,OBJ,250,,750
10/31/2023,10/31/2023,1188,Chk: CD000024 10/31/23 11555 (202310) Pacific Aviation : Bank Fee,PAV,11555,,OBJ,250,,1000
11/30/2023,11/30/2023,1256,Chk: CD000026 11/30/23 11555 (202311) Pacific Aviation : Bank Fee,PAV,11555,,OBJ,250,,1250
12/31/2023,12/31/2023,,Bank Service Charge: Service charge,PAV,11555,,CDJ,250,,1500
1/31/2024,1/31/2024,,Reclass 202312 Cash Mgmt Fee from Bank Fees to Interest Income,PAV,0,,AE,,455.88,1044.12
1/31/2024,1/31/2024,,Bank Service Charge: 11155 (202401) Pacific Aviation : Cash Management Sweep Fee,PAV,0,,CDJ,455.88,,1500
1/31/2024,1/31/2024,,Bank Service Charge: 11155 (202401) Pacific Aviation : Bank Fees,PAV,0,,CDJ,250,,1750
2/9/2024,2/9/2024,,Bank Service Charge: 11155 (202401) Pacific Aviation : Bank Fees,PAV,0,,CDJ,250,,2000
2/9/2024,2/9/2024,,Bank Service Charge: 11155 (202401) Pacific Aviation : Bank Fees,PAV,0,,CDJ,,250,1750
2/29/2024,2/29/2024,,Bank Service Charge: 11555 Pacific Aviation Corp : Bank Fees,PAV,,,CDJ,250,,2000
3/31/2024,3/31/2024,,Bank Service Charge: 11555 (202403) Pacific Aviation Corp : Bank Fees,PAV,,,CDJ,250,,2250
5/31/2024,5/31/2024,,Bank Service Charge: 11555 (202405) Pacific Aviation Corp : Bank Fees,PAV,,,CDJ,500,,2750
 Totals for 830000 - Bank Fees,,,,,,,,3455.88,705.88,2750
Grand total,,,,,,,,18177651.25,18177651.25,0
